Aaliyah 	F
 Aaric 	M
 Aaron 	M
 Aart 	M
 Abagail 	F
 Abaigael 	F
 Abaigeal 	F
 Aballach 	M
 Abarrane 	F
 Abarron 	M
 Digby M
 Abasi 	M
 Abayomi 	M
 Abba 	M
 Abban 	M
 Abbas 	M
 Abbey 	F
 Abbie 	F
 Abbigail 	F
 Abbot 	M
 Abbotson 	M
 Abbott 	M
 Abby 	F
 Abdalla 	M
 Siri F
 Abdalrahman 	M
 Abdel 	M
 Abdi 	M
 Abdikarim 	M
 Abdimelech 	M
 Abdiraxman 	M
 Abdul 	M
 Abdulla 	M
 Abdullah 	M
 Abe 	M
 Abeba 	F
 Abebe 	M
 Abebi 	F
 Abedabun 	F
 Abegayle 	F
 Abel 	M
 Abelard 	M
 Abell 	M
 Abella 	F
 Abellona 	F
 Abena 	F
 Abeodan 	M
 Abequa 	F
 Abeque 	F
 Abhainn 	M
 Abhy 	F
 Abia 	F
 Abiageal 	F
 Abichail 	F
 Abigail 	F
 Abigale 	F
 Abigayle 	F
 Abijah 	M
 Abimelech 	M
 Abir 	M
 Abiram 	M
 Abisha 	M
 Ablendan 	M
 Abner 	M
 Abooksigun 	M
 Abra 	F
 Abracham 	M
 Abrafo 	M
 Abraham 	M
 Abram 	M
 Abramo 	M
 Abran 	M
 Abrecan 	M
 Abrihet 	F
 Abril 	F
 Absalom 	M
 Abu Bakr 	M
 Abukcheech 	M
 Acacia 	F
 Acair 	M
 Acaiseid 	M
 Acca 	F
 Accalon 	M
 Acel 	M
 Aceline 	F
 Acennan 	M
 Acey 	M
 Achaius 	M
 Achak 	M
 Achan 	F
 Acheflow 	F
 Acie 	M
 Ackerley 	M
 Ackley 	M
 Acwel 	M
 Acwellen 	M
 Ada 	F
 Adah 	F
 Adahy 	M
 Adair 	M
 Adaira 	F
 Adairia 	F
 Adal 	M
 Adalard 	M
 Adalbeorht 	F
 Adalbert 	M
 Adalbrechta 	F
 Adalene 	F
 Adalgar 	M
 Adalhard 	M
 Adalheida 	F
 Adali 	F
 Adalia 	F
 Adalicia 	F
 Adalie 	F
 Adaline 	F
 Adaliz 	F
 Adalric 	M
 Adalrik 	M
 Adalson 	M
 Adalwen 	M
 Adalwin 	M
 Adalwine 	M
 Adalwolf 	M
 Adalwolfa 	F
 Adalyn 	F
 Adam 	M
 Adama 	F
 Adamnan 	M
 Adamson 	M
 Adan 	M
 Adana 	F
 Adanech 	F
 Adanna 	F
 Adar 	M
 Adara 	F
 Adare 	M
 Adda 	F
 Addam 	M
 Addaneye 	M
 Addergoole 	M
 Addie 	F
 Addis 	M
 Addison 	F
 Addney 	M
 Addo 	M
 Addy 	M
 Ade 	M
 Adeen 	F
 Adel 	M
 Adela 	F
 Adelaide 	F
 Adelbert 	M
 Adele 	F
 Adelhard 	M
 Adelheid 	F
 Adelheide 	F
 Adelia 	F
 Adelina 	F
 Adelinda 	F
 Adeline 	F
 Adelisa 	F
 Adelise 	F
 Adelita 	F
 Adell 	F
 Adella 	F
 Adelle 	F
 Adelynn 	F
 Adelyte 	F
 Aden 	M
 Adena 	F
 Adene 	F
 Adeola 	F
 Aderet 	M
 Aderrig 	M
 Adetoun 	F
 Adette 	F
 Adhamh 	M
 Adhiambo 	F
 Adia 	F
 Adiba 	F
 Adil 	M
 Adila 	F
 Adilene 	F
 Adin 	M
 Adina 	F
 Adinah 	F
 Adinam 	F
 Adine 	F
 Adir 	M
 Adira 	F
 Adisa 	M
 Aditya 	M
 Adiv 	M
 Adiva 	F
 Adjatay 	M
 Adken 	M
 Adkins 	M
 Adkyn 	M
 Adlai 	M
 Adlar 	M
 Adler 	M
 Adley 	M
 Adline 	F
 Admina 	F
 Admiral 	M
 Adnan 	M
 Adne 	M
 Adney 	M
 Adniel 	M
 Adny 	M
 Adoette 	F
 Adofo 	M
 Adolf 	M
 Adolfo 	M
 Adolph 	M
 Adolpha 	F
 Adolphus 	M
 Adom 	M
 Adon 	M
 Adonia 	F
 Adonis 	M
 Adoracion 	F
 Adorlee 	F
 Adowa 	F
 Adrain 	M
 Adreana 	F
 Adreanna 	F
 Adria 	F
 Adrian 	M
 Adriana 	F
 Adriane 	F
 Adrianna 	F
 Adrianne 	F
 Adriano 	M
 Adrie 	F
 Adriel 	M
 Adrien 	M
 Adriene 	F
 Adrienne 	F
 Adrion 	M
 Adriyel 	M
 Adron 	M
 Adsila 	F
 Advent 	M
 Adwin 	M
 Aeary 	M
 Aeccestane 	M
 Aedre 	F
 Aefentid 	F
 Aefre 	F
 Aegelmaere 	M
 Aegelweard 	M
 Aeker 	M
 Aekerley 	M
 Aekerman 	M
 Aekley 	M
 Aeldra 	M
 Aelfdane 	M
 Aelfdene 	M
 Aelfraed 	M
 Aelfric 	M
 Aelfwine 	F
 Aelle 	M
 Aenedleah 	M
 Aenescumb 	M
 Aengus 	M
 Aerlene 	F
 Aerwyna 	F
 Aescby 	M
 Aescford 	M
 Aescleah 	M
 Aesclin 	M
 Aesctun 	M
 Aethelred 	M
 Afafa 	F
 Afework 	M
 Afeworki 	M
 Afia 	F
 Afra 	F
 Afram 	M
 Afreda 	F
 Afric 	F
 Afrodille 	F
 Afton 	F
 Afua 	F
 Afya 	F
 Agacia 	F
 Agata 	F
 Agate 	F
 Agatha 	F
 Agathe 	F
 Agbenyaga 	F
 Agdta 	F
 Ager 	M
 Aggie 	F
 Aghaderg 	M
 Aghadreena 	F
 Aghamora 	F
 Aghamore 	M
 Aghaveagh 	F
 Aghavilla 	F
 Aghna 	F
 Aghy 	M
 Agiefan 	M
 Agilberht 	M
 Aglaeca 	M
 Aglaral 	M
 Aglarale 	M
 Aglaval 	M
 Agnella 	F
 Agnes 	F
 Agnese 	F
 Agneta 	F
 Agravain 	M
 Agrican 	M
 Agueda 	F
 Aguistin 	M
 Agustin 	M
 Agustine 	M
 Agyfen 	M
 Ahana 	F
 Ahane 	M
 Ahanu 	M
 Ahearn 	M
 Aheawan 	M
 Ahebban 	M
 Ahelia 	F
 Ahelie 	F
 Ahern 	M
 Ahiga 	M
 Ahmad 	M
 Ahmed 	M
 Ahmik 	M
 Ahote 	M
 Ahreddan 	M
 Ahren 	M
 Ahsalom 	M
 Ahtunowhiho 	M
 Ahuda 	F
 Ahuva 	F
 Aibne 	M
 Aida 	F
 Aidan 	M
 Aideen 	F
 Aiden 	M
 Aidia 	F
 Aidrian 	M
 Aiekin 	M
 Aife 	F
 Aifric 	F
 Aiglentina 	F
 Aiglentine 	F
 Aigneis 	F
 Aiken 	M
 Aikin 	M
 Ail 	M
 Aila 	F
 Ailani 	F
 Ailat 	F
 Ailbe 	M
 Ailbert 	M
 Ailean 	M
 Aileana 	F
 Aileen 	F
 Aileene 	F
 Ailein 	M
 Ailey 	F
 Ailfrid 	M
 Aili 	F
 Ailia 	F
 Ailidh 	F
 Ailill 	M
 Ailin 	M
 Ailis 	F
 Ailisa 	F
 Ailise 	F
 AIlison 	F
 Aillig 	M
 Ailsa 	F
 Ailse 	F
 Ailsie 	F
 Aimee 	F
 Ain 	M
 Aina 	F
 Aindreas 	M
 Aine 	F
 Aineislis 	M
 Aingeal 	F
 Ainmire 	M
 Ainsley 	F
 Ainslie 	M
 Ainsworth 	M
 Aintzane 	F
 Airell 	M
 Airic 	F
 Airleas 	M
 Aisford 	M
 Aisha 	F
 Aishah 	F
 A'ishah 	F
 Aisley 	M
 Aislin 	F
 Aisling 	F
 Aislinn 	F
 Aisly 	F
 Aiston 	M
 Aitan 	M
 Aithne 	F
 Aiya 	F
 Aiyana 	F
 Aja 	F
 Akando 	M
 Akecheta 	M
 Akeem 	M
 Akela 	F
 Akello 	M
 Akia 	M
 Akiba 	M
 Akibe 	F
 Akiha 	F
 Akil 	M
 Akilah 	F
 Akim 	M
 Akin 	M
 Akinsanya 	M
 Akintunde 	M
 Akinwole 	M
 Akinyemi 	M
 Akir 	M
 Akira 	F
 Akiva 	M
 Akker 	M
 Akosua 	F
 Akpenamawu 	F
 Akram 	M
 Aksel 	M
 Akua 	F
 Akub 	M
 Akule 	M
 Alafin 	M
 Alahhaois 	M
 Alain 	M
 Alaina 	F
 Alaine 	F
 Alair 	F
 Al'alim 	M
 Alameda 	F
 Alan 	M
 Alana 	F
 Alandra 	F
 Alane 	F
 Alani 	F
 Alanna 	F
 Alannah 	F
 Alano 	M
 Alanson 	M
 Alanza 	F
 Alanzo 	M
 Alaqua 	F
 Alaric 	M
 Alarica 	F
 Alarice 	F
 Alarick 	M
 Alarico 	M
 Alarik 	M
 Alasdair 	M
 Alastair 	M
 Alastrina 	F
 Alastrine 	F
 Alastriona 	F
 Alawa 	F
 Alayna 	F
 Alayne 	F
 Alazne 	F
 Alba 	F
 Albaric 	M
 Albern 	M
 Albert 	M
 Alberta 	F
 Alberteen 	F
 Albertha 	F
 Albertina 	F
 Albertine 	F
 Alberto 	M
 Albertyna 	F
 Albertyne 	F
 Albin 	M
 Albina 	F
 Albinus 	M
 Albion 	M
 Albiona 	F
 Albrecht 	M
 Alburn 	M
 Alburt 	M
 Alcide 	M
 Alcott 	M
 Ald 	M
 Alda 	F
 Aldan 	M
 Alden 	M
 Aldene 	F
 Alder 	M
 Aldercy 	F
 Aldfrith 	M
 Aldhelm 	M
 Aldin 	M
 Aldis 	M
 Aldn'd 	M
 Aldo 	M
 Aldona 	F
 Aldonsa 	F
 Aldonza 	F
 Aldora 	F
 Aldous 	M
 Aldred 	M
 Aldric 	M
 Aldrich 	M
 Aldrick 	M
 Aldrik 	M
 Aldrin 	M
 Aldtun 	M
 Aldus 	M
 Aldwin 	M
 Aldwine 	M
 Aldwyn 	M
 Aldys 	F
 Aleah 	F
 Alec 	M
 Alecia 	F
 Aleck 	M
 Aleda 	F
 Aleece 	F
 Aleen 	F
 Aleena 	F
 Aleeza 	F
 Aleezah 	F
 Alegria 	F
 Alejandra 	F
 Alejandrina 	F
 Alejandro 	M
 Alena 	F
 Alene 	F
 Aler 	M
 Aleron 	M
 Alesandra 	F
 Alesha 	F
 Alesia 	F
 Alessandra 	F
 Alessandro 	M
 Aleta 	F
 Aletea 	F
 Aletha 	F
 Aletia 	F
 Alex 	M
 Alexa 	F
 Alexander 	M
 Alexandra 	F
 Alexandre 	M
 Alexandrea 	F
 Alexandria 	F
 Alexandrina 	F
 Alexandrine 	F
 Alexandro 	M
 Alexi 	F
 Alexia 	F
 Alexina 	F
 Alexine 	F
 Alexis 	F
 Alexus 	F
 Alexys 	F
 Alexzander 	M
 Aleyn 	M
 Alf 	M
 Alfonsa 	F
 Alfonsine 	F
 Alfonso 	M
 Alfonzo 	M
 Alford 	M
 Alfred 	M
 Alfreda 	F
 Alfredo 	M
 Alfrid 	M
 Alfrida 	F
 Algar 	M
 Alger 	M
 Algernon 	M
 Algie 	M
 Algoma 	F
 Algrenon 	M
 Alhan 	M
 Alhertina 	F
 Alhertine 	F
 Alhhard 	M
 Alhmanic 	M
 Alhraed 	F
 Alhric 	M
 Alhrick 	M
 Alhrik 	M
 Alhsom 	M
 Alhwin 	M
 Ali 	M
 Alia 	F
 Alice 	F
 Aliceson 	M
 Alicia 	F
 Alida 	F
 Alijah 	M
 Alima 	F
 Alina 	F
 Aline 	F
 Alis 	M
 Alisa 	F
 Alisanne 	F
 Alise 	F
 Alisha 	F
 Alison 	F
 Alissa 	F
 Alisse 	F
 Alistair 	M
 Alistaire 	M
 Alister 	M
 Alisz 	F
 Alita 	F
 Alitash 	F
 Alitza 	F
 Alivia 	F
 Alix 	F
 Alixandra 	F
 Alixandre 	M
 Aliya 	F
 Aliyah 	F
 AlIyn 	F
 Aliz 	F
 Aliza 	F
 Alizah 	F
 Alize 	F
 Allaire 	F
 Allan 	M
 Allana 	F
 Allard 	M
 Allaryce 	F
 Alleffra 	F
 Allen 	M
 Allena 	F
 Allene 	F
 Allete 	F
 Alli 	F
 Allie 	F
 Alline 	F
 Allison 	F
 Alliss 	F
 Allister 	M
 Allona 	F
 Allonia 	F
 Allred 	M
 Allsun 	F
 Allura 	F
 Ally 	F
 Allyce 	F
 Allyn 	M
 Allyse 	F
 Allyson 	F
 Allyssa 	F
 Alma 	F
 Almeda 	F
 Almer 	M
 Almeta 	F
 Almira 	F
 Almo 	M
 Almon 	M
 Almund 	M
 Almunda 	F
 Almundena 	F
 Almundina 	F
 Alo 	M
 Alodia 	F
 Alodie 	F
 Aloin 	M
 Alois 	M
 Aloise 	F
 Aloisia 	F
 Alon 	M
 Alona 	F
 Alondra 	F
 Alonna 	F
 Alonsa 	F
 Alonso 	M
 Alonza 	M
 Alonzo 	M
 Aloysia 	F
 Aloysius 	M
 Alpha 	F
 Alpheus 	M
 Alphonse 	M
 Alphonsine 	F
 Alphonso 	M
 Alphonsus 	M
 Alpin 	M
 Alpina 	F
 Alric 	M
 Alrick 	M
 Alrik 	M
 Alroy 	M
 Alsandair 	M
 Alsatia 	F
 Alson 	M
 Alsoomse 	F
 Alston 	M
 Alta 	F
 Altagracia 	F
 Altair 	M
 Altaira 	F
 Alter 	M
 Altha 	F
 Althea 	F
 Altheda 	F
 Althia 	F
 Altman 	M
 Altmann 	M
 Alton 	M
 Aluin 	M
 Aluino 	M
 Alula 	F
 Aluma 	F
 Alumit 	F
 Alura 	F
 Alurea 	F
 Alva 	M
 Alvah 	M
 Alvan 	M
 Alvar 	M
 Alvara 	F
 Alvarie 	F
 Alvarita 	F
 Alvaro 	M
 Alvena 	F
 Alvera 	F
 Alverna 	F
 Alverta 	F
 Alvie 	M
 Alvin 	M
 Alvina 	F
 Alvino 	M
 Alvis 	M
 Alvord 	M
 Alvy 	M
 Alvyn 	M
 Alwalda 	M
 Alwin 	M
 Alwyn 	M
 Alyce 	F
 Alycesone 	M
 Alycia 	F
 Alyda 	F
 Alys 	F
 Alysa 	F
 Alyse 	F
 Alysha 	F
 Alysia 	F
 Alyson 	F
 Alyss 	F
 Alyssa 	F
 Alyssandra 	F
 Alysse 	F
 Alyssia 	F
 Alyx 	M
 Alzan 	F
 Alzena 	F
 Alzina 	F
 Ama 	F
 Amabella 	F
 Amabelle 	F
 Amachi 	F
 Amad 	M
 Amada 	F
 Amadahy 	F
 Amadeo 	M
 Amadi 	M
 Amado 	M
 Amaethon 	M
 Amal 	F
 Amala 	F
 Amalasand 	F
 Amalasanda 	F
 Amald 	M
 Amalda 	F
 Amalea 	F
 Amalia 	F
 Amalie 	F
 Amall 	M
 Amalur 	F
 Amalure 	F
 Aman 	M
 Amanda 	F
 Amani 	F
 Amanishakhete 	F
 Amapola 	F
 Amara 	F
 Amaranta 	F
 Amarante 	F
 Amare 	M
 Amari 	F
 Amariah 	F
 Amarion 	M
 Amaris 	F
 Amarisa 	F
 Amarise 	F
 Amarissa 	F
 Amasa 	M
 Amata 	F
 Amaud 	M
 Amaury 	M
 Amaya 	F
 Amazu 	M
 Amber 	F
 Amberlee 	F
 Amberly 	F
 Amberlyn 	F
 Amberlynn 	F
 Amblaoibh 	M
 Ambra 	F
 Ambre 	F
 Ambros 	M
 Ambrose 	M
 Ambrosi 	M
 Ambrosio 	M
 Ambrosius 	M
 Amd 	M
 Amdt 	M
 Ame 	M
 Amedee 	F
 Ameena 	F
 Ameenah 	F
 Ameerah 	F
 Amelia 	F
 Amelie 	F
 Amell 	M
 Americo 	M
 Amery 	M
 Ames 	M
 Amet 	M
 Amett 	M
 Ametta 	F
 Amette 	F
 Amey 	M
 Amhlaoibh 	M
 Amhold 	M
 Amhuinn 	M
 Ami 	F
 Amia 	F
 Amichai 	M
 Amie 	F
 Amiel 	M
 Amikam 	M
 Amin 	M
 Amina 	F
 Aminah 	F
 Aminata 	F
 Amineh 	F
 Aminia 	F
 Amir 	M
 Amira 	F
 Amirah 	F
 Amiram 	M
 Amit 	M
 Amita 	M
 Amite 	F
 Amitee 	F
 Amiti 	M
 Amitola 	F
 Amity 	F
 Amiya 	F
 Amma 	F
 Ammar 	M
 Ammi 	M
 Ammie 	F
 Ammitai 	M
 Ammon 	M
 Amnchadh 	M
 Amnon 	M
 Amo 	M
 Amold 	M
 Amoldo 	M
 Amoll 	M
 Amon 	M
 Amor 	F
 Amora 	F
 Amorica 	F
 Amory 	M
 Amos 	M
 Amot 	M
 Amott 	M
 Amou 	M
 Amoux 	M
 Amparo 	F
 Amr 	M
 Amram 	M
 Amsden 	M
 Amwolf 	M
 Amy 	F
 Amya 	F
 Ana 	F
 Anahi 	F
 Anais 	F
 Anakausuen 	M
 Analee 	F
 Analeigh 	F
 Analena 	F
 Analise 	F
 Anamari 	F
 Anamarie 	F
 Anant 	M
 Anarosa 	F
 Anastagio 	M
 Anastasia 	F
 Anastasio 	M
 Anat 	F
 Anata 	F
 Anate 	F
 Anatie 	F
 Anaya 	F
 Anbessa 	M
 Anbidian 	M
 Ance 	F
 Ancelin 	F
 Ancelina 	F
 Ancenned 	M
 Ancil 	M
 Anda 	F
 Andeana 	F
 Andee 	F
 Andena 	F
 Andera 	F
 Andere 	F
 Anderson 	M
 Andettan 	M
 Andi 	F
 Andie 	F
 Andra 	M
 Andraste 	F
 Andre 	M
 Andrea 	F
 Andreana 	F
 Andreas 	M
 Andree 	F
 Andreo 	M
 Andres 	M
 Andret 	M
 Andrew 	M
 Andria 	F
 Andrian 	M
 Andric 	M
 Andriel 	M
 Andsaca 	M
 Andsware 	F
 Andswarian 	M
 Andswaru 	M
 Andweard 	M
 Andwearde 	M
 Andwyrdan 	M
 Andy 	M
 Ane 	M
 Aneisha 	F
 AneMy 	F
 Anessa 	F
 Aneta 	F
 Anetta 	F
 Anfeald 	M
 Ange 	F
 Angela 	F
 Angeletta 	F
 Angelette 	F
 Angelia 	F
 Angelica 	F
 Angelika 	F
 Angelina 	F
 Angeline 	F
 Angelino 	M
 Angelique 	F
 Angelita 	F
 Angelo 	M
 Angeni 	F
 Angharad 	F
 Angharat 	F
 Anghus 	M
 Angie 	F
 Angilia 	F
 Anglesey 	M
 Anglides 	F
 Angus 	M
 Anguysh 	M
 Angwusnasomtaqa 	F
 Anhaga 	M
 Anibal 	M
 Anica 	F
 Anice 	F
 Anichka 	F
 Anika 	F
 Aniki 	F
 Aniko 	F
 Anir 	M
 Anisha 	F
 Anissa 	F
 Anita 	F
 Anitia 	F
 Anitra 	F
 Aniya 	F
 Aniyah 	F
 Anjali 	F
 Anjanette 	F
 Anjanique 	F
 Anjeanette 	F
 Anjelica 	F
 Anka 	F
 Anke 	F
 Anki 	F
 Ankti 	F
 Anku 	F
 Anlicnes 	F
 Anlienisse 	F
 Anlon 	M
 Anluan 	M
 Anmcha 	M
 Ann 	F
 Anna 	F
 Annabel 	F
 Annabell 	F
 Annabella 	F
 Annabelle 	F
 Annabeth 	F
 Annabla 	F
 Annaduff 	M
 Annakiya 	F
 Annalee 	F
 Annaliese 	F
 Annalisa 	F
 Annalise 	F
 Annamae 	F
 Annamaria 	F
 Annamarie 	F
 Annan 	M
 Anne 	F
 Anneliese 	F
 Annelise 	F
 Annemarie 	F
 Annemette 	F
 Annemie 	F
 Anner 	F
 Annetta 	F
 Annette 	F
 Anni 	F
 Annice 	F
 Annie 	F
 Annika 	F
 Annikka 	F
 Annikke 	F
 Annikki 	F
 Annis 	F
 Annissa 	F
 Annjeanette 	F
 Annmarie 	F
 Annora 	F
 Annorah 	F
 Annot 	F
 Anntoin 	M
 Annuziata 	F
 Annwn 	F
 Anny 	F
 Annze 	F
 Anoki 	M
 Anora 	F
 Anscom 	M
 Anscomb 	M
 Ansel 	M
 Ansell 	M
 Anselmo 	M
 Ansgar 	M
 Ansleigh 	M
 Ansley 	F
 Anson 	M
 Antfortas 	M
 Anthony 	M
 Antione 	M
 Antionette 	F
 Antje 	F
 Antoine 	M
 Antoinette 	F
 Anton 	M
 Antone 	M
 Antonette 	F
 Antonia 	F
 Antonie 	F
 Antonietta 	F
 Antonina 	F
 Antonio 	M
 Antony 	M
 Antor 	M
 Antwan 	M
 Antwon 	M
 Anulika 	F
 Anunciacion 	F
 Anwealda 	M
 Anwell 	M
 Anwyl 	M
 Anya 	F
 Anyon 	M
 Anyssa 	F
 Anyuta 	F
 Aod 	M
 Aodh 	M
 Aodhan 	M
 Aodhfin 	M
 Aodhfionn 	M
 Aoibheann 	F
 Aoidh 	M
 Aoife 	F
 Aolani 	F
 Aonghus 	M
 Ap Owen 	M
 Apenimon 	M
 Aphra 	F
 Aphria 	F
 Apollina 	F
 Apolline 	F
 Apollo 	M
 Aponi 	F
 Aponivi 	M
 Apryl 	F
 Apryll 	F
 Apsel 	M
 Aquanetta 	F
 Aquene 	F
 Aquilina 	F
 Aquilino 	M
 Ara 	F
 Arabella 	F
 Araceli 	F
 Aracelia 	F
 Aracely 	F
 Aralt 	M
 Aram 	M
 Arama 	F
 Araminta 	F
 Araminte 	F
 Aramis 	M
 Aranck 	M
 Ararinda 	F
 Arawn 	M
 Arber 	M
 Arcadia 	F
 Arcelia 	F
 Arcene 	F
 Archaimbaud 	M
 Archambault 	M
 Archard 	M
 Archenhaud 	M
 Archer 	M
 Archerd 	M
 Archere 	M
 Archibald 	M
 Archibaldo 	M
 Archie 	M
 Archimbald 	M
 Arcilla 	F
 Arda 	F
 Ardagh 	M
 Ardal 	M
 Ardala 	F
 Ardaleah 	M
 Ardath 	F
 Ardeen 	F
 Ardel 	M
 Ardelia 	F
 Ardell 	F
 Ardella 	F
 Ardelle 	F
 Arden 	M
 Ardena 	F
 Ardene 	F
 Ardi 	F
 Ardine 	F
 Ardis 	F
 Ardith 	F
 Ardkill 	M
 Ardleigh 	M
 Ardley 	M
 Ardolf 	M
 Ardolph 	M
 Ardon 	M
 Ardra 	F
 Ardwolf 	M
 Ardyne 	F
 Ardys 	F
 Areille 	F
 Arela 	F
 Areli 	F
 Arella 	F
 Arely 	F
 Aren 	M
 Arend 	M
 Aret 	F
 Areta 	F
 Aretha 	F
 Argante 	F
 Argyle 	M
 Ari 	M
 Aria 	F
 Arian 	M
 Ariana 	F
 Ariane 	F
 Arianna 	F
 Arianrod 	F
 Aric 	M
 Aricela 	F
 Arick 	M
 Aridatha 	F
 Arie 	F
 Ariel 	F
 Ariela 	F
 Ariele 	F
 Arielle 	F
 Ariellel 	F
 Arienh 	F
 Arietta 	F
 Ariette 	F
 Arif 	M
 Arik 	M
 Arion 	M
 ArIyn 	M
 ArIyne 	F
 Arizona 	F
 Arjean 	F
 Arjun 	M
 Arkwright 	M
 Arla 	F
 Arlan 	M
 Arlana 	F
 Arland 	M
 Arlando 	M
 Arleana 	F
 Arledge 	M
 Arleen 	F
 Arleena 	F
 Arleene 	F
 Arleigh 	M
 Arlen 	M
 Arlena 	F
 Arlene 	F
 Arlenna 	F
 Arleta 	F
 Arletta 	F
 Arlette 	F
 Arley 	M
 Arlice 	M
 Arlie 	M
 Arlin 	M
 Arlina 	F
 Arlinda 	F
 Arline 	F
 Arlington 	M
 Arliss 	F
 Arlo 	M
 Arlyn 	M
 Arlyne 	F
 Arlys 	M
 Arlyss 	M
 Armand 	M
 Armanda 	F
 Armando 	M
 Armani 	M
 Armen 	M
 Armida 	F
 Armin 	M
 Armina 	F
 Arminda 	F
 Arminta 	F
 Armon 	M
 Armond 	M
 Armstrang 	M
 Armstrong 	M
 Arnan 	M
 Arnatt 	M
 Arndell 	M
 Arne 	M
 Arnelle 	F
 Arnet 	M
 Arnett 	M
 Arno 	M
 Arnold 	M
 Arnoldo 	M
 Arnott 	M
 Arnt 	M
 Arnulfo 	M
 Aron 	M
 Arregaithel 	M
 Arrick 	M
 Arrie 	F
 Arrigo 	M
 Arron 	M
 Artair 	M
 Artegal 	M
 Artemisia 	F
 Arth 	M
 Arther 	M
 Arthgallo 	M
 Arthur 	M
 Arthurine 	F
 Arthw 	M
 Artie 	F
 Artis 	M
 Artur 	M
 Arturo 	M
 Artus 	M
 Arub 	F
 Aruba 	F
 Arundel 	M
 Arusi 	F
 Arvad 	M
 Arvada 	F
 Arvel 	M
 Arvid 	M
 Arvie 	M
 Arvil 	M
 Arvilla 	F
 Arvin 	M
 Arvis 	M
 Arvon 	M
 Arwin 	M
 Arwood 	M
 Arwyn 	M
 Arwyroe 	M
 Aryan 	M
 Aryana 	F
 Aryanna 	F
 Arye 	M
 Aryeh 	M
 Asa 	M
 Asabi 	F
 Asad 	M
 Asaf 	M
 Asante 	M
 Asaph 	M
 Asbury 	M
 Ascencion 	F
 Ascott 	M
 Asenka 	F
 Asenke 	F
 Asfour 	M
 Asfoureh 	F
 Ash 	M
 Asha 	F
 Ashaki 	F
 Ashanti 	F
 Ashburn 	M
 Ashby 	M
 Ashely 	F
 Asher 	M
 Ashford 	M
 Ashia 	F
 Ashira 	F
 Ashkii 	M
 Ashla 	F
 Ashleah 	F
 Ashlee 	F
 Ashleen 	F
 Ashleena 	F
 Ashleigh 	F
 Ashlen 	F
 Ashley 	F
 Ashli 	F
 Ashlie 	F
 Ashlin 	M
 Ashling 	F
 Ashlinn 	F
 Ashly 	F
 Ashlyn 	F
 Ashlynn 	F
 Ashlynne 	F
 Ashten 	F
 Ashtin 	M
 Ashton 	M
 Ashtyn 	F
 Ashur 	M
 Ashwin 	M
 Ashwyn 	M
 Asia 	F
 Asianne 	F
 Asim 	M
 Asima 	F
 Askook 	M
 Askuwheteau 	M
 Asliraf 	M
 Asmina 	F
 Aspen 	F
 Assaggi 	F
 Assan 	M
 Assana 	F
 Assane 	F
 Assefa 	M
 Asthore 	F
 Astolat 	F
 Astrid 	F
 Astyrian 	M
 Asucena 	F
 Asuncion 	F
 Asura 	F
 Aswad 	M
 Asya 	F
 Ata 	M
 Ata'halne' 	M
 Atalaya 	F
 Atalia 	F
 Atalie 	F
 Atara 	F
 Atarah 	F
 Atelic 	M
 Atepa 	F
 Atera 	F
 Ateret 	F
 Atha 	F
 Athaleyah 	F
 Athalia 	F
 Athalie 	F
 Athdar 	M
 Athdara 	F
 Athelstan 	M
 Athelston 	M
 Athelward 	M
 Athemar 	M
 Athena 	F
 Atherton 	M
 Athilda 	F
 Athmarr 	M
 Athmore 	M
 Athracht 	F
 Atia 	F
 Atilda 	F
 Atira 	F
 Atiya 	F
 Atkinson 	M
 Atkinsone 	M
 Atmore 	M
 Atol 	M
 Atonia 	F
 Ator 	M
 Atsukpi 	F
 Attewater 	M
 Attewell 	M
 Attewode 	M
 Atteworthe 	M
 Attheaeldre 	F
 Attie 	F
 Attilio 	M
 Attkins 	M
 Attmore 	M
 Attor 	M
 Attracta 	F
 Attwell 	M
 Atty 	M
 Atu 	M
 Atwater 	M
 Atwell 	M
 Atwood 	M
 Atworth 	M
 Atyhtan 	M
 Auberta 	F
 Aubin 	M
 Aubina 	F
 Aubine 	F
 Aubree 	F
 Aubrey 	M
 Aubriana 	F
 Aubrianne 	F
 Aubrie 	F
 Aubry 	M
 Auctor 	M
 Auda 	F
 Aude 	F
 Audel 	M
 Audelia 	F
 Auden 	M
 Audene 	F
 Audie 	M
 Audley 	M
 Audra 	F
 Audre 	F
 Audrea 	F
 Audreana 	F
 Audreanna 	F
 Audree 	F
 Audrey 	F
 Audri 	F
 Audria 	F
 Audriana 	F
 Audrianna 	F
 Audric 	M
 Audrick 	M
 Audrie 	F
 Audrielle 	F
 Audrina 	F
 Audris 	F
 Audry 	F
 Audwin 	M
 Audwine 	M
 August 	M
 Augusta 	F
 Augusteen 	F
 Augustine 	M
 Augustus 	M
 Augwys 	M
 Auhert 	M
 Auley 	M
 Auliffe 	M
 Aundre 	M
 Aura 	F
 Aurear 	F
 Aurelia 	F
 Aureliana 	F
 Aureliano 	M
 Aurelio 	M
 Aurelius 	M
 Auriar 	F
 Aurick 	M
 Aurik 	M
 Auriville 	M
 Aurkena 	F
 Aurkene 	F
 Aurnia 	F
 Aurora 	F
 Aurore 	F
 Austen 	M
 Austin 	M
 Austina 	F
 Austine 	F
 Auston 	M
 Austyn 	M
 Auther 	M
 Ava 	F
 Avagail 	F
 Avah 	F
 Avalee 	F
 Avalloc 	M
 Avalon 	F
 Avaron 	F
 Avarona 	F
 Avelaine 	F
 Avelina 	F
 Aveline 	F
 Avelyn 	F
 Avenall 	M
 Aveneil 	M
 Avenelle 	M
 Avent 	M
 Avera 	F
 Averell 	M
 Averil 	M
 Averill 	M
 Avery 	M
 Averyl 	F
 Avi 	M
 Avia 	F
 Aviana 	F
 Aviance 	F
 Avianna 	F
 Avice 	F
 Avichai 	M
 Avichayil 	F
 Avidan 	M
 Avidor 	M
 Avie 	F
 Aviel 	M
 Avigail 	F
 Avigdor 	M
 Avilon 	F
 Avimelech 	M
 Avinoam 	M
 Aviram 	M
 Avis 	F
 Avisha 	M
 Avishai 	M
 Avital 	M
 Aviv 	M
 Aviva 	F
 Avivah 	F
 Avivi 	F
 Avivit 	F
 Avlynn 	F
 Avner 	M
 Avniel 	M
 Avonaco 	M
 Avonmora 	F
 Avonmore 	M
 Avraham 	M
 Avriel 	F
 Avril 	F
 Avrill 	F
 Avryl 	F
 Avsalom 	M
 Avshalom 	M
 Awan 	M
 Awarnach 	M
 Awenasa 	F
 Awendela 	F
 Awenita 	F
 Awiergan 	M
 Awinita 	F
 Awnan 	M
 Axel 	M
 Axella 	F
 Axelle 	F
 Axton 	M
 Aya 	F
 Ayala 	F
 Ayalah 	F
 Ayan 	F
 Ayana 	F
 Ayanna 	F
 Ayasha 	F
 Ayashe 	F
 Ayawamat 	M
 Ayda 	F
 Aydan 	M
 Ayden 	M
 Ayeisha 	F
 Ayers 	M
 Ayesha 	F
 Ayisha 	F
 Ayita 	F
 Ayla 	F
 Aylin 	F
 Aylmer 	M
 Aylward 	M
 Ayn 	F
 Ayo 	F
 Ayrwode 	M
 Aysha 	F
 Ayska 	F
 Ayub 	M
 Ayubu 	M
 Aza 	F
 Azalea 	F
 Azaria 	M
 Azarious 	M
 Azaryah 	M
 Azaryahu 	M
 Azekel 	M
 Azelia 	F
 Azelie 	F
 Azhar 	F
 Azhara 	F
 Azi 	M
 Azia 	F
 Azibo 	M
 Aziel 	F
 Azikiwe 	M
 Azima 	F
 Azinza 	F
 Aziza 	F
 Azizah 	F
 Azizi 	M
 Azmera 	M
 Azriel 	M
 Azucena 	F
 Azura 	F
 Azure 	F
 Azurine 	F
 Azusa 	F
 Azusena 	F
 Azzam 	M
 Bab 	F
 Babatunde 	M
 Babette 	F
 Babu 	M
 Baby 	M
 Bac 	M
 Backstere 	M
 Badru 	M
 Badu 	M
 Baecere 	M
 Baen 	M
 Baerhloew 	M
 Baethan 	M
 Bagdemagus 	M
 Baghel 	M
 Bahati 	F
 Bahir 	M
 Bahira 	F
 Baibre 	F
 Baigh 	M
 Bailee 	F
 Bailey 	F
 Bailintin 	M
 BaIloch 	M
 Bainbridge 	M
 Bainbrydge 	M
 Baird 	M
 Bairrfhionn 	M
 Bairrfhoinn 	M
 Baker 	M
 Balbina 	F
 Baldemar 	M
 Balder 	M
 Baldhart 	F
 Baldhere 	M
 Baldlice 	M
 Baldric 	M
 Baldrik 	M
 Balduin 	M
 Baldulf 	M
 Baldwin 	M
 Baldwyn 	M
 Balen 	M
 Balfour 	M
 Balgair 	M
 Balgaire 	M
 Balin 	M
 Balinda 	F
 Ballard 	M
 Ballinamore 	M
 Ballindeny 	M
 Balmoral 	M
 Baltasar 	M
 Bama 	F
 Bamard 	M
 Bambi 	F
 Bamey 	M
 Bana 	M
 Banaing 	M
 Banan 	M
 Banbhan 	M
 Banbrigge 	M
 Bancroft 	M
 Bannan 	M
 Banner 	M
 Banning 	M
 Bannruod 	M
 Barak 	M
 Baraka 	F
 Barakah 	M
 Baram 	M
 Barbara 	F
 Barbi 	F
 Barbie 	F
 Barbra 	F
 Barclay 	M
 Bard 	M
 Bardalph 	M
 Bardan 	M
 Bardaric 	M
 Bardarik 	M
 Bardawulf 	M
 Barday 	M
 Barden 	M
 Bardene 	M
 Bardo 	M
 Bardolf 	M
 Bardolph 	M
 Bardon 	M
 Bardrick 	M
 Bardulf 	M
 Barhloew 	M
 Bari 	M
 Barlow 	M
 Barnabas 	M
 Barnabe 	M
 Barnaby 	M
 Barnard 	M
 Barnet 	M
 Barnett 	M
 Barney 	M
 Barnum 	M
 Baron 	M
 Barr 	M
 Barra 	M
 Barrak 	M
 Barram 	M
 Barran 	F
 Barre 	M
 Barret 	M
 Barrett 	M
 Barric 	M
 Barrick 	M
 Barrie 	M
 Barrington 	M
 Barron 	M
 Barry 	M
 Bart 	M
 Bartel 	M
 Barth 	M
 Bartholomew 	M
 Barthram 	M
 Bartleah 	M
 Bartleigh 	M
 Bartlett 	M
 Bartley 	M
 Bartoli 	M
 Bartolo 	M
 Bartolome 	M
 Barton 	M
 Bartram 	M
 Baruch 	M
 Barwolf 	M
 Bascom 	M
 Basel 	M
 Bashiga 	F
 Bashira 	F
 Bashshar 	M
 Basil 	M
 Basilio 	M
 Basilius 	M
 Bates 	M
 Bathild 	F
 Bathilda 	F
 Bathilde 	F
 Bathsheba 	F
 Batista 	F
 Battseeyon 	F
 Battzion 	F
 Batul 	F
 Batula 	F
 Batya 	F
 Bawdewyn 	M
 Bawdewyne 	M
 Bax 	M
 Baxter 	M
 Bayard 	M
 Bayen 	M
 Bayhard 	M
 Baylee 	F
 Baylen 	M
 Bayley 	M
 Baylie 	F
 Beacan 	M
 Beacher 	M
 Beadu 	F
 Beadurinc 	M
 Beadutun 	M
 Beadwof 	M
 Beal 	M
 Beale 	M
 Beall 	M
 Bealohydig 	M
 Beaman 	M
 Beamard 	M
 Beamer 	M
 Bean 	M
 Bearacb 	M
 Bearcban 	M
 Bearn 	M
 Bearnard 	M
 Bearrocscir 	F
 Beartlaidh 	M
 Beatha 	F
 Beathag 	F
 Beathan 	M
 Beathas 	F
 Beaton 	M
 Beatrice 	F
 Beatricia 	F
 Beatrisa 	F
 Beatriz 	F
 Beau 	M
 Beaufort 	M
 Beaulah 	F
 Beaumains 	M
 Beauvais 	M
 Bebeodan 	M
 Bebhinn 	F
 Becan 	M
 Becca 	F
 Beceere 	M
 Beck 	M
 Becki 	F
 Becky 	F
 Beda 	F
 Bede 	M
 Bedegrayne 	F
 Bedford 	M
 Bedivere 	M
 Bedver 	M
 Bedwyr 	M
 Beecher 	M
 Beinvenido 	M
 Beiste 	M
 Bek 	M
 Bekele 	M
 Bel 	F
 Bela 	M
 Belakane 	F
 Belda 	F
 Beldan 	M
 Beldane 	M
 Belden 	M
 Beldene 	M
 Beldon 	M
 Belen 	F
 Belinda 	F
 Bell 	F
 Bella 	F
 Bellamy 	M
 Bellangere 	M
 Belle 	F
 Bellinus 	M
 Beltran 	M
 Beluchi 	M
 Belva 	F
 Bem 	M
 Bemabe 	M
 Bemadette 	F
 Bembe 	M
 Bemeere 	M
 Bemelle 	M
 Bemia 	F
 Bemossed 	M
 Bemot 	M
 Ben 	M
 Bena 	F
 Benat 	M
 Bendigeidfran 	M
 Benecroft 	M
 Benedetta 	F
 Benedict 	M
 Benedicto 	M
 Benedictson 	M
 Benen 	M
 Beniamino 	M
 Benigna 	F
 Benita 	F
 Benito 	M
 Benjaman 	M
 Benjamin 	M
 Benjamine 	M
 Benji 	M
 Benjiman 	M
 Benjy 	M
 Benkamin 	M
 Benn 	M
 Bennet 	M
 Bennett 	M
 Bennie 	M
 Benny 	M
 Benoic 	M
 Benon 	M
 Benoni 	M
 Benoyce 	M
 Benroy 	M
 Benson 	M
 Bentleah 	M
 Bentleigh 	M
 Bentley 	M
 Benton 	M
 Benwick 	M
 Benzion 	M
 Beolagh 	M
 Beomann 	M
 Beomia 	F
 Beore 	M
 Beorht 	M
 Beorhthilde 	F
 Beorhthram 	M
 Beorhthramm 	M
 Beorhttun 	M
 Beorn 	M
 Beornet 	M
 Beornham 	M
 Beornwulf 	M
 Beortbtraed 	F
 Beowulf 	M
 Ber 	M
 Berakhiah 	M
 Berangari 	F
 Berangaria 	F
 Berchtwald 	M
 Bercilak 	M
 Bercleah 	M
 Berde 	M
 Berdie 	F
 Berdina 	F
 Berdine 	F
 Berdy 	M
 Berend 	M
 Berengaria 	F
 Berenice 	F
 Beresford 	M
 Beretun 	M
 Berford 	M
 Berg 	M
 Bergitte 	F
 Berhane 	M
 Berhanu 	M
 Beric 	M
 Berihun 	M
 Berinhard 	M
 Berit 	F
 Berk 	M
 Berke 	M
 Berkeley 	M
 Berkley 	M
 Berlyn 	M
 Bernadea 	F
 Bernadette 	F
 Bernadina 	F
 Bernadine 	F
 Bernard 	M
 Bernarda 	F
 Bernardine 	F
 Bernardo 	M
 Bernardyn 	M
 Bernd 	M
 Berne 	M
 Berneen 	F
 Berneice 	F
 Bernelle 	F
 Bernetta 	F
 Bernette 	F
 Bernhard 	M
 Bernice 	F
 Bernicia 	F
 Bernie 	M
 Berniece 	F
 Berniss 	F
 Bernita 	F
 Bernlak 	M
 Bernon 	M
 Bernyce 	F
 Berowalt 	M
 Berrin 	M
 Berry 	M
 Bersules 	M
 Bert 	M
 Berta 	F
 Bertha 	F
 Berthe 	F
 Berthold 	M
 Bertie 	F
 Bertilda 	F
 Bertilde 	F
 Bertin 	M
 Bertina 	F
 Berto 	M
 Berton 	M
 Bertrade 	F
 Bertram 	M
 Bertrand 	M
 Bertrando 	M
 Beruriah 	F
 Berwick 	M
 Berwyk 	M
 Beryl 	F
 Bess 	F
 Besse 	F
 Bessie 	F
 Bessy 	F
 Bestandan 	M
 Besyrwan 	M
 Beth 	F
 Betha 	F
 Bethanee 	F
 Bethani 	F
 Bethanie 	F
 Bethann 	F
 Bethany 	F
 Bethea 	F
 Bethel 	F
 Betheli 	F
 Bethia 	F
 Bethiar 	F
 Bethsaida 	F
 Bethseda 	F
 Bethsheba 	F
 Betia 	F
 Betje 	F
 Betlic 	M
 Betsey 	F
 Betsy 	F
 Bette 	F
 Betti 	F
 Bettie 	F
 Bettina 	F
 Bettine 	F
 Betty 	F
 Bettye 	F
 Betzalel 	M
 Beula 	F
 Beulah 	F
 Bevan 	M
 Beverlee 	F
 Beverley 	F
 Beverly 	F
 Bevin 	M
 Bevis 	M
 Bevyn 	M
 Bhaic 	M
 Bhaltair 	M
 Bhradain 	M
 Bhraghad 	M
 Bhreac 	M
 Bhric 	M
 Bianca 	F
 Biast 	M
 Bibi 	F
 Bibiana 	F
 Bibsbebe 	F
 Bick 	M
 Bickford 	M
 Bicoir 	M
 Biddie 	F
 Biddy 	F
 Bidelia 	F
 Bidina 	F
 Bidziil 	M
 Biecaford 	M
 Bienvenida 	F
 Biford 	M
 Bilagaana 	M
 Bilal 	M
 Bill 	M
 Billie 	F
 Billy 	M
 Billye 	F
 Bimisi 	M
 Binah 	M
 Binata 	F
 Bing 	M
 Bing Qing 	F
 Binga 	F
 Bink 	M
 Binta 	F
 Binyamin 	M
 Birche 	M
 Birde 	M
 Birdena 	F
 Birdhil 	M
 Birdhill 	M
 Birdie 	F
 Birdine 	F
 Birdoswald 	M
 Birdy 	F
 Birgit 	F
 Birk 	M
 Birkett 	M
 Birkey 	M
 Birkhead 	M
 Birkhed 	M
 Birkita 	F
 Birley 	M
 Birney 	M
 Biron 	M
 Birr 	M
 Birt 	M
 Birte 	F
 Birtel 	M
 Birtha 	F
 Birtie 	F
 Birtle 	M
 Bisgu 	F
 Bitanig 	M
 Bittan 	M
 Bitya 	F
 Blaec 	M
 Blaecleah 	M
 Blaed 	M
 Blaeey 	M
 Blagdan 	M
 Blagden 	M
 Blagdon 	M
 Blaine 	M
 Blainey 	M
 Blair 	M
 Blaire 	F
 Blais 	M
 Blaisdell 	M
 Blaise 	M
 Blaize 	M
 Blake 	M
 Blakeley 	M
 Blakely 	M
 Blakemore 	M
 Blakey 	M
 Blanca 	F
 Blanch 	F
 Blanche 	F
 Blanchefleur 	F
 Blancheflor 	F
 Blancheflour 	F
 Blanco 	M
 Blandford 	M
 Blandina 	F
 Blane 	M
 Blaney 	M
 Blanford 	M
 Blar 	M
 Blas 	M
 Blasa 	F
 Blase 	M
 Blathma 	M
 Blathnaid 	F
 Blayne 	M
 Blayney 	M
 Blayze 	M
 Blaze 	M
 Bleecker 	M
 Blerung 	F
 Blessing 	F
 Bletsung 	F
 Blian 	M
 Bliant 	M
 Bliss 	M
 Blisse 	F
 Bliths 	F
 Blondell 	F
 Blondelle 	F
 Blondene 	F
 Blostm 	F
 Bluinse 	F
 Bly 	F
 Blyana 	F
 Blyss 	F
 Blysse 	F
 Blyth 	M
 Blythe 	M
 Boadicea 	F
 Boarte 	M
 Boas 	M
 Boaz 	M
 Bob 	M
 Bobbi 	F
 Bobbie 	F
 Bobby 	M
 Bobbye 	F
 Bobo 	M
 Boc 	M
 Bocleah 	M
 Bocley 	M
 Boda 	M
 Bodaway 	M
 Boden 	M
 Bodiccea 	F
 Bodicea 	F
 Bodicia 	F
 Bodil 	M
 Bodwyn 	M
 Boell 	M
 Bogart 	M
 Bogdan 	M
 Bogohardt 	M
 Bohannon 	M
 Bohdan 	M
 Bohort 	M
 Bolton 	M
 Bond 	M
 Bondig 	M
 Bonie 	F
 Boniface 	M
 Bonifacio 	M
 Bonifaco 	M
 Bonita 	F
 Bonni 	F
 Bonnibelle 	F
 Bonnie 	F
 Bonnie-jo 	F
 Bonny 	F
 Bonny-jean 	F
 Bonny-lee 	F
 Booker 	M
 Boone 	M
 Booth 	M
 Boothe 	M
 Borak 	M
 Bordan 	M
 Borden 	M
 Boris 	M
 Borre 	M
 Bors 	M
 Bort 	M
 Bosworth 	M
 Botewolf 	M
 Bothain 	M
 Bothan 	M
 Bothe 	M
 Botolf 	M
 Botwolf 	M
 Boudicea 	F
 Boulus 	M
 Bourke 	M
 Bourn 	M
 Bourne 	M
 Bowden 	M
 Bowdyn 	M
 Bowen 	M
 Bowie 	M
 Bowyn 	M
 Boyce 	M
 Boyd 	M
 Boyden 	M
 Boynton 	M
 Bozi 	F
 Bple 	M
 Brachah 	F
 Brad 	M
 Bradaigh 	M
 Bradan 	M
 Bradana 	F
 Bradbourne 	M
 Bradburn 	M
 Bradd 	M
 Braddock 	M
 Braddon 	M
 Braden 	M
 Bradene 	M
 Bradford 	M
 Bradig 	M
 Bradleah 	M
 Bradlee 	M
 Bradley 	M
 Bradly 	M
 Bradon 	M
 Bradshaw 	M
 Bradwell 	M
 Brady 	M
 Bradyn 	M
 Braeden 	M
 Braedon 	M
 Braemwiella 	M
 Braiden 	M
 Brain 	M
 Brainard 	M
 Brainerd 	M
 Braleah 	M
 Bram 	M
 Bramwell 	M
 Bran 	M
 Branda 	F
 Brandan 	M
 Branddun 	M
 Brande 	F
 Brandee 	F
 Brandeis 	M
 Brandeles 	M
 Brandelis 	M
 Brandelyn 	F
 Branden 	M
 Brandi 	F
 Brandice 	F
 Brandie 	F
 Brandilyn 	F
 Brandin 	M
 Brandon 	M
 Brandt 	M
 Brandubh 	M
 Branduff 	M
 Brandy 	F
 Brandyce 	F
 Brandyn 	M
 Brangaine 	F
 Branhard 	M
 Branigan 	M
 Brann 	M
 Brannan 	M
 Brannen 	M
 Brannon 	M
 Branor 	M
 Branson 	M
 Brant 	M
 Brantley 	M
 Branton 	M
 Brantson 	M
 Branwen 	F
 Branwyn 	F
 Braoin 	M
 Brarn 	M
 Brasil 	M
 Brawleigh 	M
 Brawley 	M
 Braxton 	M
 Brayan 	M
 Brayden 	M
 Braydon 	M
 Brea 	F
 Breac 	M
 Breana 	F
 Breanainn 	M
 Breandan 	M
 Breann 	F
 Breanna 	F
 Breanne 	F
 Breasal 	M
 Brecc 	M
 Breck 	F
 Bredbeddle 	M
 Bredon 	M
 Bree 	F
 Breeda 	F
 Breen 	M
 Breena 	F
 Breezy 	F
 Brehus 	M
 Bren 	M
 Brenda 	F
 Brendalynn 	F
 Brendan 	M
 Brenden 	M
 Brendis 	M
 Brendolyn 	F
 Brendon 	M
 Brendt 	M
 Brenius 	M
 Brenn 	M
 Brenna 	F
 Brennan 	M
 Brennen 	M
 Brennon 	M
 Brennus 	M
 Brent 	M
 Brentan 	M
 Brenten 	M
 Brentley 	M
 Brently 	M
 Brenton 	M
 Breonna 	F
 Breri 	M
 Breslin 	M
 Bressal 	M
 Bret 	M
 Brett 	M
 Bretta 	F
 Brettany 	F
 Brette 	F
 Bretton 	M
 Breuse 	M
 Brewster 	M
 Brewstere 	M
 Bria 	F
 Brian 	M
 Briana 	F
 Briann 	F
 Brianna 	F
 Briannah 	F
 Brianne 	F
 Briannon 	F
 Briant 	M
 Brice 	M
 Brick 	M
 Brickman 	M
 Bricriu 	M
 Brid 	F
 Bridger 	M
 Bridget 	F
 Bridgett 	F
 Bridgette 	F
 Brielle 	F
 Brien 	M
 Brienna 	F
 Brienne 	F
 Brietta 	F
 Brigantia 	F
 Brigbam 	M
 Brigette 	F
 Briggebam 	M
 Briggere 	M
 Brigham 	M
 Brighid 	F
 Brigid 	F
 Brigida 	F
 Brigidia 	F
 Brigitta 	F
 Brigitte 	F
 Brik 	M
 Brimlad 	F
 Brina 	F
 Brinton 	M
 Brion 	M
 Brione 	F
 Brioni 	F
 Brionna 	F
 Brionne 	F
 Briony 	F
 Brisa 	F
 Brisha 	F
 Brisia 	F
 Brissa 	F
 Brit 	F
 Brita 	F
 Britani 	F
 Britany 	F
 Brite 	F
 Brites 	F
 Britney 	F
 Britni 	F
 Britt 	M
 Britta 	F
 Brittain 	M
 Brittan 	M
 Brittaney 	F
 Brittani 	F
 Brittanie 	F
 Brittany 	F
 Brittnee 	F
 Brittney 	F
 Brittni 	F
 Brittny 	F
 Britton 	M
 Briza 	F
 Broc 	M
 Brochan 	M
 Brock 	M
 Brockley 	M
 Brocleah 	M
 Brocleigh 	M
 Brocly 	M
 Broden 	M
 Broderic 	M
 Broderick 	M
 Broderik 	M
 Brodie 	M
 Brodric 	M
 Brodrick 	M
 Brodrig 	M
 Brodrik 	M
 Brody 	M
 Broehain 	M
 Broga 	M
 Brogan 	M
 Broin 	M
 Brok 	M
 Bromleah 	M
 Bromleigh 	M
 Bromley 	M
 Bromly 	M
 Bron 	M
 Brona 	F
 Brone 	M
 Bronson 	M
 Brook 	F
 Brooke 	F
 Brooklyn 	F
 Brooklynn 	F
 Brooklynne 	F
 Brooks 	M
 Brookson 	M
 Brooksone 	M
 Brougher 	M
 Broughton 	M
 Bruce 	M
 Brucie 	F
 Bruhier 	M
 Brun 	M
 Bruna 	F
 Brune 	F
 Brunella 	F
 Brunelle 	M
 Brunhild 	F
 Brunhilda 	F
 Brunhilde 	F
 Bruno 	M
 Brunon 	M
 Bryan 	M
 Bryana 	F
 Bryani 	F
 Bryann 	F
 Bryanna 	F
 Bryanne 	F
 Bryant 	M
 Bryce 	M
 Brycen 	M
 Bryceton 	M
 Brydger 	M
 Bryggere 	M
 Brygid 	F
 Bryna 	F
 Brynda 	F
 Bryne 	M
 Brynn 	F
 Bryon 	M
 Bryony 	F
 Brys 	M
 Bryson 	M
 Bryssa 	F
 Bryston 	M
 Bssil 	M
 Buach 	M
 Buagh 	M
 Buan 	F
 Buchanan 	M
 Buck 	M
 Buckley 	M
 Budd 	M
 Buddie 	M
 Buddy 	M
 Buena 	F
 Buffy 	F
 Buford 	M
 Buinton 	M
 Buiron 	M
 Bulah 	F
 Bundy 	M
 Bupe 	F
 Burbank 	M
 Burcet 	M
 Burch 	M
 Burchard 	M
 Burdett 	M
 Burdette 	M
 Burdon 	M
 Bureig 	M
 Burel 	M
 Burford 	M
 Burgeis 	M
 Burgess 	M
 Burghard 	M
 Burghere 	M
 Burgtun 	M
 Burhardt 	M
 Burhbank 	M
 Burhdon 	M
 Burhford 	M
 Burhleag 	M
 Burhtun 	M
 Burke 	M
 Burkett 	M
 Burkhart 	M
 Burl 	M
 Burle 	M
 Burleigh 	M
 Burley 	M
 Burlin 	M
 Burly 	M
 Burnard 	M
 Burne 	M
 Burneig 	M
 Burnell 	M
 Burnette 	M
 Burney 	M
 Burns 	M
 Burr 	M
 Burrell 	M
 Bursone 	M
 Burt 	M
 Burton 	M
 Busiris 	M
 Buster 	M
 Butch 	M
 Buthaynah 	F
 Butler 	M
 Butrus 	M
 Bwana 	M
 Byford 	M
 Byme 	M
 Byram 	M
 Byrd 	M
 Byrdene 	F
 Byreleah 	M
 Byrne 	M
 Byrnes 	M
 Byron 	M
 Byrtel 	M
 Bysen 	F
 Cabe 	M
 Cacamwri 	M
 Cacanisius 	M
 Cace 	M
 Cacey 	M
 Cachamwri 	M
 Cacia 	F
 Cadabyr 	M
 Cadby 	M
 Cadda 	M
 Caddaham 	M
 Caddaric 	M
 Caddarik 	M
 Caddawyc 	M
 Cade 	M
 Cadee 	F
 Cadell 	M
 Caden 	M
 Cadena 	F
 Cadence 	F
 Cadencia 	F
 Cadenza 	F
 Cadha 	F
 Cadhla 	M
 Cadi 	F
 Cadie 	F
 Cadman 	M
 Cador 	M
 Cadwallon 	M
 Cady 	F
 Cadyna 	F
 Caedmon 	M
 Caedwalla 	M
 Cael 	M
 Caerleon 	M
 Caersewiella 	M
 Caesar 	M
 Cafall 	M
 Caffar 	M
 Caffara 	F
 Caffaria 	F
 Caflice 	M
 Cagney 	M
 Cahal 	M
 Cahir 	M
 Cahira 	F
 Cai 	M
 Caiden 	M
 Cailean 	M
 Cailin 	M
 Cailleach 	F
 Caillen 	M
 Caillic 	F
 Cain 	M
 Caindale 	M
 Caine 	M
 Cairbre 	M
 Caiseal 	M
 Cait 	F
 Caith 	M
 Caitie 	F
 Caitlan 	F
 Caitland 	F
 Caitlin 	F
 Caitlinn 	F
 Caitlyn 	F
 Caitlynn 	F
 Caitrin 	F
 Cal 	M
 Caladh 	M
 Calan 	M
 Calandre 	F
 Calandria 	F
 Calantha 	F
 Calanthe 	F
 Calbert 	M
 Calbex 	M
 Calbhach 	M
 Calder 	M
 Caldre 	M
 Caldwell 	M
 Caldwiella 	M
 Cale 	M
 Caleb 	M
 Caleigh 	F
 Caley 	M
 Calfhierde 	M
 Calhoun 	M
 Cali 	F
 Caliana 	F
 Calibom 	M
 Calibome 	M
 Calibor 	M
 Calibum 	M
 Calibumus 	M
 Calida 	F
 Calinda 	F
 Calista 	F
 Calla 	F
 Callaghan 	M
 Callahan 	M
 Calldwr 	M
 Callee 	F
 Calli 	F
 Callie 	F
 Callough 	M
 Callum 	M
 Callyr 	F
 Calogrenant 	M
 Calum 	M
 Calvagh 	M
 Calvert 	M
 Calvex 	M
 Calvin 	M
 Calvina 	F
 Calvino 	M
 Caly 	M
 Calynda 	F
 Cam 	M
 Camara 	M
 Cambeul 	M
 Camdan 	M
 Camden 	M
 Camdene 	M
 Camdin 	M
 Camdyn 	M
 Camella 	F
 Camellia 	F
 Camelon 	M
 Camelot 	F
 Cameo 	F
 Camero 	M
 Cameron 	M
 Camey 	M
 Camhlaidh 	M
 Camila 	F
 Camile 	F
 Camilla 	F
 Camille 	F
 Camillei 	F
 Camlann 	M
 Cammeo 	F
 Cammi 	F
 Cammie 	F
 Campbell 	M
 Camren 	M
 Camron 	M
 Camryn 	F
 Camshron 	M
 Candace 	F
 Candi 	F
 Candice 	F
 Candida 	F
 Candide 	F
 Candie 	F
 Candis 	F
 Candiss 	F
 Candyce 	F
 Canice 	M
 Cantara 	F
 Caoilfhinnn 	F
 Caoimhe 	F
 Caoimhghin 	M
 Caolaidhe 	M
 Caolan 	M
 Caomh 	M
 Capitola 	F
 Caprice 	F
 Capucina 	F
 Capucine 	F
 Cara 	F
 Caradawc 	M
 Caradoc 	M
 Caraid 	F
 Caraidland 	M
 Caralyn 	F
 Carbry 	M
 Cardew 	M
 Caree 	F
 Carel 	M
 Caren 	F
 Caressa 	F
 Caresse 	F
 Carew 	M
 Carey 	M
 Cari 	F
 Carie 	F
 Carilla 	F
 Carilyn 	F
 Carilynne 	F
 Carin 	F
 Carina 	F
 Carine 	F
 Carisa 	F
 Carissa 	F
 Carl 	M
 Carla 	F
 Carlatun 	M
 Carlee 	F
 Carleen 	F
 Carlene 	F
 Carleton 	M
 Carletta 	F
 Carley 	F
 Carli 	F
 Carlie 	F
 Carlin 	M
 Carlisle 	M
 Carlita 	F
 Carlo 	M
 Carlomagno 	M
 Carlos 	M
 Carlota 	F
 Carlotta 	F
 Carlson 	M
 Carlton 	M
 Carly 	F
 Carlyle 	M
 Carma 	F
 Carmel 	F
 Carmela 	F
 Carmelide 	M
 Carmelina 	F
 Carmeline 	F
 Carmelita 	F
 Carmella 	F
 Carmelo 	M
 Carmen 	F
 Carmencita 	F
 Carmi 	M
 Carmia 	F
 Carmichael 	M
 Carmina 	F
 Carmine 	M
 Carmita 	F
 Carmya 	F
 Carnation 	F
 Carnell 	M
 Carney 	M
 Caro 	F
 Carol 	F
 Carola 	F
 Carolan 	F
 Carolann 	F
 Carolanne 	F
 Carole 	F
 Carolee 	F
 Caroliana 	F
 Carolina 	F
 Caroline 	F
 Carolos 	M
 Carolus 	M
 Carolyn 	F
 Carolyne 	F
 Carolynn 	F
 Caron 	F
 Carona 	F
 Carr 	M
 Carrado 	M
 Carraig 	M
 Carree 	F
 Carressa 	F
 Carri 	F
 Carrick 	M
 Carrie 	F
 Carrington 	M
 Carrol 	M
 Carrola 	F
 Carroll 	M
 Carson 	M
 Carswell 	M
 Carter 	M
 Cartere 	M
 Carthach 	M
 Carthage 	M
 Cartimandua 	F
 Cartland 	M
 Carvel 	M
 Carvell 	M
 Carver 	M
 Cary 	M
 Caryl 	F
 Caryn 	F
 Carynn 	F
 Casandra 	F
 Caseareo 	M
 Casee 	F
 Casey 	M
 Cashel 	M
 Casidhe 	F
 Casie 	F
 Casimer 	M
 Casimir 	M
 Casimiro 	M
 Cason 	M
 Casper 	M
 Cass 	M
 Cassandra 	F
 Cassi 	F
 Cassian 	M
 Cassidy 	F
 Cassie 	F
 Cassius 	M
 Cassivellaunus 	M
 Cassondra 	F
 Cassy 	F
 Casta 	F
 Caster 	M
 Caswallan 	M
 Catalina 	F
 Catarina 	F
 Cate 	F
 Cateline 	F
 Catelyn 	F
 Caterina 	F
 Cath 	M
 Cathair 	M
 Cathal 	M
 Cathaoir 	M
 Catharine 	F
 Cathasach 	F
 Catherine 	F
 Catheryn 	F
 Cathey 	F
 Cathi 	F
 Cathia 	F
 Cathie 	F
 Cathleen 	F
 Cathmor 	M
 Cathmore 	M
 Cathrine 	F
 Cathryn 	F
 Cathy 	F
 Catina 	F
 Catlee 	F
 Catlin 	F
 Catline 	F
 Catlyn 	F
 Catori 	F
 Catrice 	F
 Catrina 	F
 Catriona 	F
 Cattee 	F
 Catterick 	M
 Catterik 	M
 Cauley 	M
 Cavalon 	M
 Cavan 	M
 Cavana 	F
 Caw 	M
 Cawley 	M
 Caycee 	F
 Cayden 	M
 Cayla 	F
 Cayle 	M
 Ceallach 	M
 Ceallachan 	M
 Ceapmann 	M
 Cearbhall 	M
 Ceard 	M
 Ceardach 	M
 Cearnach 	M
 Cearo 	F
 Ceasario 	M
 Ceaster 	M
 Ceastun 	M
 Ceawlin 	M
 Cecelia 	F
 Cecil 	M
 Cecile 	F
 Cecilia 	F
 Cecilio 	M
 Cecilius 	M
 Cecille 	F
 Cedd 	M
 Cedra 	F
 Cedric 	M
 Cedrica 	F
 Cedrick 	M
 Cedrina 	F
 Cedro 	M
 Cein 	M
 Ceire 	F
 Celdtun 	M
 Celesse 	F
 Celesta 	F
 Celeste 	F
 Celestia 	F
 Celestiel 	F
 Celestina 	F
 Celestine 	F
 Celestyna 	F
 Celia 	F
 Celie 	F
 Celina 	F
 Celine 	F
 Celsus 	M
 Celyddon 	M
 Cendrillon 	F
 Cenehard 	M
 Cenewig 	M
 Cenewyg 	M
 Cenobia 	F
 Cenwalh 	M
 Ceola 	F
 Ceolbeorht 	M
 Ceolfrith 	M
 Ceolwulf 	M
 Cerdic 	M
 Cerelia 	F
 Cerella 	F
 Ceri 	F
 Ceria 	F
 Cerise 	F
 Cesar 	M
 Cesara 	F
 Cesare 	M
 Cesario 	M
 Cesaro 	M
 Cetewind 	M
 Cha'akmongwi 	M
 Chaba 	F
 Chabah 	F
 Chace 	M
 Chad 	M
 Chadburn 	M
 Chadburne 	M
 Chadbyrne 	M
 Chadd 	M
 Chadrick 	M
 Chadwick 	M
 Chadwik 	M
 Chadwyk 	M
 Chaga 	M
 Chagai 	M
 Chaim 	M
 Chait 	M
 Chaka 	M
 Cha'kwaina 	F
 Chalina 	F
 Chalmer 	M
 Chalmers 	M
 Chan 	M
 Chan Juan 	F
 Chana 	F
 Chanah 	F
 Chanan 	M
 Chancellor 	M
 Chancey 	M
 Chanda 	F
 Chandler 	M
 Chandra 	F
 Chane 	M
 Chanel 	F
 Chanell 	F
 Chanelle 	F
 Chaney 	M
 Chang 	F
 Chankoowashtay 	M
 Chanler 	M
 Chann 	M
 Channe 	M
 Channelle 	F
 Channing 	M
 Channon 	M
 Chano 	M
 Chanoch 	M
 Chansomps 	M
 Chantae 	F
 Chantal 	F
 Chantalle 	F
 Chantay 	F
 Chante 	F
 Chantel 	F
 Chantell 	F
 Chantelle 	F
 Chantrell 	F
 Chapalu 	M
 Chapin 	M
 Chapman 	M
 Chappel 	M
 Chappell 	M
 Chardae 	F
 Charee 	F
 Charis 	F
 Cha'risa 	F
 Charissa 	F
 Charisse 	F
 Charla 	F
 Charlaine 	F
 Charlayne 	F
 Charlee 	F
 Charleen 	F
 Charleena 	F
 Charlena 	F
 Charlene 	F
 Charles 	M
 Charleson 	M
 Charleston 	M
 Charleton 	M
 Charlette 	F
 Charley 	M
 Charli 	F
 Charlie 	M
 Charline 	F
 Charlisa 	F
 Charlita 	F
 Charlot 	M
 Charlotta 	F
 Charlotte 	F
 Charlton 	M
 Charly 	M
 Charlyn 	F
 Charlynn 	F
 Charmain 	F
 Charmaine 	F
 Charmayne 	F
 Charmine 	F
 Charo 	F
 Charolette 	F
 Charro 	M
 Chas 	M
 Chas chunk a 	M
 Chasen 	M
 Chasidah 	F
 Chasity 	F
 Chastity 	F
 Chasya 	F
 Chasye 	F
 Chatham 	M
 Cha'tima 	M
 Chatlie 	F
 Chattan 	M
 Chatwin 	M
 Chatwyn 	M
 Chaunce 	M
 Chaunceler 	M
 Chauncey 	M
 Chauncy 	M
 Chaunte 	F
 Chauntel 	F
 Chava 	F
 Chavatangakwunua 	M
 Chavela 	F
 Chavelle 	F
 Chaviv 	M
 Chaviva 	F
 Chavive 	F
 Chavivi 	M
 Chaya 	F
 Chayce 	M
 Chayim 	M
 Chayka 	F
 Chayne 	M
 Chayo 	M
 Chayton 	M
 Chaz 	M
 Che 	M
 Chedva 	F
 Cheikh 	M
 Chela 	F
 Chelinda 	F
 Chelinde 	F
 Chelsa 	F
 Chelsea 	F
 Chelsee 	F
 Chelsey 	F
 Chelsi 	F
 Chelsie 	F
 Chelsy 	F
 Chen 	M
 Chenelle 	F
 Cheney 	M
 Chenoa 	F
 Chepe 	M
 Chephzibah 	F
 Chepi 	F
 Chepito 	M
 Cher 	F
 Chere 	F
 Cheree 	F
 Chereen 	F
 Cherell 	F
 Cherelle 	F
 Cherese 	F
 Cheresse 	F
 Cheri 	F
 Cherice 	F
 Cherie 	F
 Cherilyn 	F
 Cherilynn 	F
 Cherina 	F
 Cherine 	F
 Cherisa 	F
 Cherise 	F
 Cherish 	F
 Cherisse 	F
 Cherita 	F
 Cherokee 	M
 Cherree 	F
 Cherrell 	F
 Cherrelle 	F
 Cherri 	F
 Cherrie 	F
 Cherrill 	F
 Cherry 	F
 Cheryl 	F
 Cheryle 	F
 Cheryll 	F
 Chesley 	M
 Chesmu 	M
 Chester 	M
 Cheston 	M
 Chet 	M
 Chetwin 	M
 Chetwyn 	M
 Cheval 	M
 Chevalier 	M
 Chevell 	M
 Cheveyo 	M
 Chevy 	M
 Cheyanna 	F
 Cheyanne 	F
 Cheyenne 	F
 Cheyne 	M
 Chiana 	F
 Chianna 	F
 Chiara 	F
 Chica 	F
 Chicha 	M
 Chico 	M
 Chiku 	F
 Chilam 	F
 Chilton 	M
 Chimalis 	F
 Chinaka 	F
 Chinara 	F
 Chinua 	M
 Chip 	M
 Chiquita 	F
 Chiram 	M
 Chisholm 	M
 Chitsa 	F
 Chlodwig 	M
 Chloe 	F
 Chochmingwu 	F
 Chochmo 	M
 Chochokpi 	M
 Chochuschuvio 	M
 Chogan 	M
 Cholena 	F
 Choncey 	M
 Choni 	M
 Choovio 	M
 Chosovi 	F
 Chosposi 	F
 Choviohoya 	M
 Chowilawu 	M
 Chris 	M
 Chrisanna 	F
 Chrisanne 	F
 Chriselda 	F
 Chrissa 	F
 Chrissie 	F
 Chrissy 	F
 Christ 	M
 Christa 	F
 Christabel 	F
 Christal 	F
 Christan 	F
 Christana 	F
 Christanne 	F
 Christeen 	F
 Christeena 	F
 Christel 	F
 Christen 	F
 Christena 	F
 Christene 	F
 Christi 	F
 Christian 	M
 Christiana 	F
 Christiane 	F
 Christiansen 	M
 Christie 	F
 Christien 	M
 Christin 	F
 Christina 	F
 Christine 	F
 Christofer 	M
 Christoffer 	M
 Christofferson 	M
 Christofor 	M
 Christop 	M
 Christoper 	M
 Christophe 	M
 Christopher 	M
 Christy 	F
 Christyn 	F
 Chrysann 	F
 Chrystal 	F
 Chrystina 	F
 Chu'a 	M
 Chuchip 	M
 Chuck 	M
 Chu'mana 	F
 Chunta 	M
 Churchill 	M
 Churchyll 	M
 Chu'si 	F
 Chyna 	F
 Chynna 	F
 Cian 	M
 Cianan 	M
 Ciar 	F
 Ciara 	F
 Ciarrai 	M
 Ciatlllait 	F
 Cibil 	F
 Cicely 	F
 Cicero 	M
 Ciceron 	M
 Cicily 	F
 Cidney 	F
 Cidro 	M
 Ciera 	F
 Cierra 	F
 Cillian 	M
 Cim 	F
 Cimberleigh 	F
 Cinda 	F
 Cindel 	F
 Cinderella 	F
 Cindi 	F
 Cindia 	F
 Cindy 	F
 Cingeswell 	M
 Cingeswiella 	M
 Cinneide 	M
 Cinnia 	F
 Cinnie 	F
 Cinwell 	M
 Cipriana 	F
 Cipriano 	M
 Ciqala 	M
 Cira 	F
 Circehyll 	M
 Ciri 	F
 Cirilla 	F
 Cirilo 	M
 Ciro 	M
 Cisco 	M
 Citlali 	F
 Clach 	M
 Clady 	F
 Claec 	M
 Claefer 	F
 Claeg 	M
 Claegborne 	M
 Claegtun 	M
 Claennis 	F
 Claiborn 	M
 Claiborne 	M
 Clair 	M
 Claire 	F
 Clamedeus 	M
 Clancy 	M
 Clara 	F
 Clarabelle 	F
 Clarance 	M
 Clare 	F
 Clarence 	M
 Claressa 	F
 Claresta 	F
 Clareta 	F
 Clarette 	F
 Claribel 	F
 Clarice 	F
 Clarimond 	F
 Clarimonda 	F
 Clarimonde 	F
 Clarinda 	F
 Clarine 	F
 Clarion 	M
 Clarisa 	F
 Clarissa 	F
 Clarissant 	F
 Clarisse 	F
 Clarita 	F
 Clark 	M
 Clarke 	M
 Clarrisa 	F
 Claud 	M
 Claude 	M
 Claudelle 	F
 Claudette 	F
 Claudia 	F
 Claudie 	F
 Claudina 	F
 Claudine 	F
 Claudio 	M
 Claudios 	M
 Claudius 	M
 Clay 	M
 Clayborne 	M
 Claybourne 	M
 Clayburn 	M
 Clayton 	M
 Cleantha 	F
 Cleavon 	M
 Cleit 	M
 Clem 	M
 Clemence 	F
 Clemens 	M
 Clement 	M
 Clementina 	F
 Clementine 	F
 Clementius 	M
 Clemmie 	F
 Clennan 	M
 Cleo 	F
 Cleon 	M
 Cleonie 	F
 Cleora 	F
 Cleta 	F
 Cletus 	M
 Cleva 	F
 Cleve 	M
 Cleveland 	M
 Clevon 	M
 Cliff 	M
 Clifford 	M
 Cliffton 	M
 Clifland 	M
 Clifton 	M
 Cliftun 	M
 Clint 	M
 Clinton 	M
 Clinttun 	M
 Clintwood 	M
 Clive 	M
 Clodagh 	F
 Clodovea 	F
 Clodoveo 	M
 Clora 	F
 Clotilda 	F
 Clotilde 	F
 Clovis 	M
 Cloyd 	M
 Cluny 	M
 Clust 	M
 Clustfeinad 	M
 Clyde 	M
 Clyffton 	M
 Clyfland 	M
 Clyford 	M
 Clyftun 	M
 Clyve 	M
 Cnidel 	M
 Cnut 	M
 Coburn 	M
 Coby 	M
 Cochava 	F
 Cocheta 	F
 Cochise 	M
 Cochlain 	M
 Cocidius 	M
 Coco 	F
 Codee 	F
 Codell 	M
 Codey 	M
 Codi 	M
 Codie 	M
 Codier 	F
 Cody 	M
 Codyr 	F
 Cofahealh 	M
 Coghlan 	M
 Coilin 	M
 Coillcumhann 	M
 Coinneach 	M
 Coira 	F
 Coire 	M
 CoireaIl 	M
 Colan 	M
 Colbert 	M
 Colbey 	M
 Colby 	M
 Cole 	M
 Coleen 	F
 Coleman 	M
 Colemann 	M
 Colene 	F
 Coleta 	F
 Coletta 	F
 Colette 	F
 Coletun 	M
 Coley 	M
 Colfre 	M
 Colier 	M
 Colin 	M
 Colina 	F
 Colis 	M
 Colla 	M
 Colleen 	F
 Collena 	F
 Collene 	F
 Colletta 	F
 Collette 	F
 Collie 	M
 Collier 	M
 Collin 	M
 Collins 	M
 Collis 	M
 Collyer 	M
 Colm 	M
 Colman 	M
 Colmcilla 	F
 Colmcille 	M
 Colonel 	M
 Colquhoun 	M
 Colson 	M
 Colten 	M
 Colter 	M
 Coltere 	M
 Colton 	M
 Coltrane 	M
 Columbine 	F
 Columbo 	M
 Columbus 	M
 Colver 	M
 Colvert 	M
 Colvyr 	M
 Colyer 	M
 Colyn 	M
 Colys 	M
 Coman 	M
 Comort 	F
 Comorte 	F
 Comhghan 	M
 Commodore 	M
 Comyn 	M
 Comyna 	F
 Conaire 	M
 Conal 	M
 Conall 	M
 Conan 	M
 Conant 	M
 Conary 	M
 Concepcion 	F
 Concepta 	F
 Concetta 	F
 Concha 	F
 Conchetta 	F
 Conchobar 	M
 Conchobara 	F
 Conchobarra 	F
 Conchobarre 	F
 Conchobhar 	M
 Condan 	M
 Condon 	M
 Condwiramurs 	F
 Cong 	M
 Congalie 	F
 Conlan 	M
 Conleth 	M
 Conley 	M
 Conn 	M
 Connacht 	M
 Connal 	M
 Connell 	M
 Conner 	M
 Connie 	F
 Connla 	M
 Connlaio 	M
 Connolly 	M
 Connor 	M
 Conny 	M
 Conor 	M
 Conrad 	M
 Conradin 	M
 Conradina 	F
 Conradine 	F
 Conrado 	M
 Conroy 	M
 Conshita 	F
 Consolacion 	F
 Consolata 	F
 Constance 	F
 Constancia 	F
 Constantia 	F
 Constantina 	F
 Constantine 	M
 Constantino 	M
 Constanza 	F
 Constanzia 	F
 Consuela 	F
 Consuelo 	F
 Conway 	M
 Cony 	M
 Cooey 	M
 Cooley 	M
 Coolie 	M
 Cooney 	M
 Cooper 	M
 Coopersmith 	M
 Cora 	F
 Coral 	F
 Coralee 	F
 Coralia 	F
 Coralie 	F
 Coraline 	F
 Coralyn 	F
 Corann 	M
 Corazana 	F
 Corazon 	F
 Corben 	M
 Corbenic 	M
 Corbett 	M
 Corbin 	M
 Corbmac 	M
 Corby 	M
 Corbyn 	M
 Corcoran 	M
 Corda 	F
 Cordale 	M
 Corday 	M
 Cordelia 	F
 Cordell 	M
 Cordero 	M
 Cordia 	F
 Cordie 	F
 Coreen 	F
 Coreene 	F
 Corella 	F
 Corene 	F
 Coretta 	F
 Corette 	F
 Corey 	M
 Cori 	F
 Coriann 	F
 Corianne 	F
 Corie 	F
 Corin 	M
 Corina 	F
 Corine 	F
 Corinna 	F
 Corinne 	F
 Corisa 	F
 Corissa 	F
 Corky 	M
 Corlan 	M
 Corlene 	F
 Corley 	M
 Corliss 	F
 Cormac 	M
 Cormack 	M
 Cormic 	M
 Cormick 	M
 Cornelia 	F
 Cornelio 	M
 Cornelious 	M
 Cornelius 	M
 Cornell 	M
 Corradeo 	M
 Corrado 	M
 Corran 	M
 Correen 	F
 Correena 	F
 Corren 	M
 Correy 	M
 Corri 	F
 Corrianna 	F
 Corrianne 	F
 Corrick 	M
 Corrie 	F
 Corrin 	M
 Corrine 	F
 Corrissa 	F
 Corry 	F
 Cort 	M
 Cortez 	M
 Cortland 	M
 Cortney 	F
 Corvin 	M
 Corwan 	M
 Corwin 	M
 Corwine 	M
 Corwyn 	M
 Cory 	M
 Cosette 	F
 Costello 	M
 Cotovatre 	F
 Coty 	M
 Coughlan 	M
 Coulter 	M
 Courtenay 	M
 Courtland 	M
 Courtlyn 	F
 Courtnay 	M
 Courtney 	F
 Covell 	M
 Coventina 	F
 Covey 	M
 Covyll 	M
 Cowan 	M
 Cowen 	M
 Cowyn 	M
 Coy 	M
 Coyan 	M
 Coyle 	M
 Coyne 	M
 Cradawg 	M
 Craig 	M
 Crandall 	M
 Crandell 	M
 Cranleah 	M
 Cranley 	M
 Cranly 	M
 Crannog 	M
 Cranston 	M
 Cranstun 	M
 Crawford 	M
 Crayton 	M
 Creed 	M
 Creedon 	M
 Creiddyladl 	F
 Creighton 	M
 Creissant 	F
 Creketun 	M
 Crescent 	F
 Crespin 	M
 Cretien 	M
 Crevan 	M
 Crichton 	M
 Cris 	M
 Crisann 	F
 Crisanna 	F
 Crispin 	M
 Crissa 	F
 Crissie 	F
 Crissy 	F
 Crista 	F
 Cristal 	F
 Cristen 	F
 Cristi 	F
 Cristian 	M
 Cristiano 	M
 Cristie 	F
 Cristin 	F
 Cristina 	F
 Cristine 	F
 Cristobal 	M
 Cristofer 	M
 Cristofor 	M
 Cristoforo 	M
 Criston 	M
 Cristopher 	M
 Cristos 	M
 Cristoval 	M
 Cristy 	F
 Cristyn 	F
 Croften 	M
 Crofton 	M
 Crogher 	M
 Crohoore 	M
 Crom 	M
 Crombwiella 	M
 Crompton 	M
 Cromwell 	M
 Cronan 	M
 Crosleah 	M
 Crosleigh 	M
 Crosley 	M
 Crosly 	M
 Crowley 	M
 Croydon 	M
 Cruadhlaoich 	M
 Cruim 	M
 Cruz 	M
 Crystal 	F
 Csilla 	F
 Cuanaic 	M
 Cuartio 	M
 Cuarto 	M
 Cuchulain 	M
 Cuinn 	M
 Culain 	M
 Culann 	M
 Culbart 	M
 Culbert 	M
 Culhwch 	M
 Cullan 	M
 Cullen 	M
 Cullin 	M
 Cullo 	M
 Culloden 	M
 Cullodena 	F
 Cullodina 	F
 Culver 	M
 Cumania 	F
 Cumhea 	M
 Cumin 	M
 Cumina 	F
 Cunningham 	M
 Curley 	M
 Curran 	M
 Currito 	M
 Curro 	M
 Curt 	M
 Curtice 	M
 Curtis 	M
 Curtiss 	M
 Cus 	M
 Custennin 	M
 Cuthbeorht 	M
 Cuthbert 	M
 Cutler 	M
 CuUladh 	M
 Cuyler 	M
 Cwen 	F
 Cwene 	F
 Cwentun 	M
 Cydnee 	F
 Cydney 	F
 Cym 	F
 Cymberly 	F
 Cynburleigh 	F
 Cyndee 	F
 Cyndi 	F
 Cyndy 	F
 Cyne 	F
 Cyneburhleah 	F
 Cyneleah 	M
 Cyneley 	M
 Cyneric 	M
 Cynerik 	M
 Cynhard 	M
 Cyning 	M
 Cynric 	M
 Cynrik 	M
 Cynthia 	F
 Cyntia 	F
 Cyprian 	M
 Cyrano 	M
 Cyril 	M
 Cyrill 	M
 Cyrilla 	F
 Cyrus 	M
 Dabi 	M
 Dabir 	M
 Dace 	M
 Dacey 	M
 Dacian 	M
 Dacio 	M
 Dack 	M
 Daedbot 	F
 Daeg 	M
 Daegal 	M
 Daegan 	M
 Dael 	M
 Daelan 	M
 Daelyn 	F
 Daena 	F
 Daesgesage 	F
 Dagan 	M
 Daganya 	F
 Daganyah 	F
 Dagen 	M
 Dagian 	F
 Dagmar 	F
 Dagoberto 	M
 Dagomar 	F
 Dagonet 	M
 Daguenet 	M
 Dagwood 	M
 Dahy 	M
 Daibheid 	M
 Daileass 	M
 Daimh 	M
 Daimhin 	M
 Dain 	M
 Daina 	F
 Daine 	M
 Daire 	M
 Daisey 	F
 Daisha 	F
 Daisi 	F
 Daisie 	F
 Daisy 	F
 Daithi 	M
 Daizy 	F
 Dakota 	M
 Dakotah 	M
 Dal 	M
 Dalan 	M
 Dalbert 	M
 Dale 	M
 Dalen 	M
 Dalena 	F
 Dalene 	F
 Dalenna 	F
 Daley 	M
 Dalia 	F
 Daliah 	F
 Dalila 	F
 Dalis 	F
 Dalit 	F
 Daliyah 	F
 Dallan 	M
 Dallas 	M
 Dallen 	M
 Dallin 	M
 Dallis 	F
 Dallon 	M
 Dalmar 	M
 Dalon 	M
 Dalston 	M
 Dalton 	M
 Daly 	F
 Dalyell 	M
 Dalyn 	M
 Dalziel 	M
 Daman 	M
 Damario 	M
 Damarion 	M
 Damaris 	F
 Dameon 	M
 Damh 	M
 Damhnait 	F
 Damia 	F
 Damian 	M
 Damiana 	F
 Damiane 	F
 Damien 	M
 Damion 	M
 Damita 	F
 Damon 	M
 Damond 	M
 Dan 	M
 Dana 	F
 Danae 	F
 Danah 	F
 Dandre 	M
 Dane 	M
 Danel 	M
 Danele 	F
 Danell 	M
 Danelle 	F
 Danetta 	F
 Danette 	F
 Daney 	F
 Dangelo 	M
 Dani 	M
 Dania 	F
 Daniachew 	M
 Danial 	M
 Danica 	F
 Danice 	F
 Daniel 	M
 Daniela 	F
 Daniele 	M
 Daniella 	F
 Danielle 	F
 Danil 	M
 Danila 	M
 Danilo 	M
 Danise 	F
 Danit 	F
 Danita 	F
 Danitza 	F
 Dann 	M
 Danna 	F
 Dannah 	F
 Dannalee 	F
 Dannee 	F
 Dannell 	F
 Dannelle 	F
 Danni 	F
 Dannia 	F
 Dannie 	M
 Dannon 	F
 Danny 	M
 Danon 	M
 Danrelle 	F
 Danso 	M
 Dantae 	M
 Dante 	M
 Dantel 	M
 Dantina 	F
 Danton 	M
 D'anton 	M
 Dantrell 	M
 Dany 	F
 Danya 	F
 Danyelle 	F
 Danylynn 	F
 Daphna 	F
 Daphnah 	F
 Daphne 	F
 Daquan 	M
 Dar 	M
 Dara 	F
 Darach 	M
 Daracha 	F
 Darah 	F
 Daran 	M
 Darby 	F
 Darcel 	M
 Darcell 	M
 Darcelle 	F
 Darcey 	F
 Darchelle 	F
 Darci 	F
 Darcia 	F
 Darcie 	F
 Darcio 	M
 Darcy 	F
 D'Arcy 	F
 Dareau 	M
 Dareen 	F
 Darek 	M
 Darel 	M
 Darelene 	F
 Darell 	M
 Darelle 	F
 Daren 	M
 Darence 	M
 Darerca 	F
 Daria 	F
 Darian 	M
 Daric 	M
 Darice 	F
 Darick 	M
 Dariel 	M
 Dariell 	M
 Darien 	M
 Darin 	M
 Dario 	M
 Darion 	M
 Darissa 	F
 Darius 	M
 Darla 	F
 Darleane 	F
 Darleen 	F
 Darleena 	F
 Darlena 	F
 Darlene 	F
 Darlina 	F
 Darline 	F
 Darnall 	M
 Darneil 	M
 Darnel 	M
 Darnell 	M
 Darnetta 	F
 Darnisha 	F
 Darold 	M
 Darolyn 	F
 Daron 	M
 Darra 	F
 Darragh 	M
 Darrah 	F
 Darrance 	M
 Darrel 	M
 Darrell 	M
 Darrellyn 	F
 Darren 	M
 Darrence 	M
 Darrian 	M
 Darrick 	M
 Darrien 	M
 Darrill 	F
 Darrin 	M
 Darrion 	M
 Darrius 	M
 Darroch 	M
 Darrock 	M
 Darrold 	M
 Darroll 	M
 Darron 	M
 Darry 	M
 Darryl 	M
 Darryle 	M
 Darryll 	M
 Darryn 	M
 Dartagnan 	M
 Darton 	M
 Darvell 	M
 Darvin 	M
 Darwin 	M
 Darwyn 	M
 Dary 	M
 Daryl 	M
 Daryle 	M
 Darylene 	F
 Daryll 	M
 Darylyn 	F
 Dashawn 	M
 Dasia 	F
 Daudi 	M
 Daunte 	M
 Dave 	M
 Daveen 	F
 Daveney 	F
 Daveon 	M
 Davet 	M
 Davey 	M
 Davi 	M
 Davia 	F
 Davian 	M
 Davianna 	F
 David 	M
 Davida 	F
 Davide 	M
 Davidson 	M
 Davidsone 	M
 Davie 	M
 Daviel 	M
 Davin 	M
 Davina 	F
 Davinah 	F
 Davine 	F
 Davinia 	F
 Davion 	M
 Daviot 	M
 Davis 	M
 Davison 	M
 Davita 	F
 Davitah 	F
 Davite 	F
 Davon 	M
 Davonna 	F
 Davonte 	M
 Davy 	M
 Davynn 	F
 Dawayne 	M
 Dawit 	M
 Dawna 	F
 Dawne 	F
 Dawnelle 	F
 Dawnetta 	F
 Dawnette 	F
 Dawnielle 	F
 Dawnika 	F
 Dawson 	M
 Dawud 	M
 Dax 	M
 Daxton 	M
 Dayana 	F
 Dayanara 	F
 Daylan 	M
 Dayle 	M
 Daylen 	M
 Daylin 	M
 Daylon 	M
 Dayna 	F
 Dayne 	M
 Dayner 	M
 Daysi 	F
 Dayson 	M
 Dayton 	M
 Deacon 	M
 Deaglan 	M
 Deagmund 	M
 Deakin 	M
 Dealbeorht 	M
 Dealbert 	M
 Dean 	M
 Deana 	F
 Deanda 	F
 Deandra 	F
 Deandre 	M
 Deandrea 	F
 Deandria 	F
 Deane 	M
 Deangelo 	M
 Deann 	F
 Deanna 	F
 Deanne 	F
 Dearbhail 	F
 Dearborn 	M
 Dearbourne 	M
 Dearg 	M
 Deasia 	F
 Deavon 	M
 Deb 	F
 Debbi 	F
 Debbie 	F
 Debbra 	F
 Debby 	F
 Debi 	F
 Debora 	F
 Deborah 	F
 Debra 	F
 Debrah 	F
 Debralee 	F
 Dechtire 	F
 Decla 	F
 Declan 	M
 Dedra 	F
 Dedre 	F
 Dedric 	M
 Dedrick 	M
 Dedrik 	M
 Dee 	F
 Deeana 	F
 Deeandra 	F
 Deeann 	F
 Deeanna 	F
 Deedee 	F
 Deedra 	F
 Deegan 	M
 Deems 	M
 Deen 	M
 Deena 	F
 Deerward 	M
 Defena 	F
 Deheune 	F
 Deidra 	F
 Deidre 	F
 Deiene 	F
 Deikun 	F
 Deina 	F
 Deion 	M
 Deirdra 	F
 Deirdre 	F
 Deja 	F
 Dejuan 	M
 Deka 	F
 Deke 	M
 Dekel 	M
 Dekle 	M
 Del 	M
 Dela O Kande 	F
 Delaine 	M
 Delancy 	M
 Delane 	M
 Delaney 	F
 Delano 	M
 Delbert 	M
 Delcine 	F
 Delfina 	F
 Delia 	F
 Delice 	F
 Delicia 	F
 Delila 	F
 Delilah 	F
 Delisa 	F
 Delisha 	F
 Delissa 	F
 Delit 	F
 Deliza 	F
 Dell 	M
 Della 	F
 Dellar 	F
 Dellie 	F
 Delma 	F
 Delman 	M
 Delmar 	M
 Delmara 	F
 Delmare 	F
 Delmas 	M
 Delmer 	M
 Delmi 	F
 Delmira 	F
 Delmon 	M
 Delmont 	M
 Delmore 	M
 Delmy 	F
 Delois 	F
 Delora 	F
 Delores 	F
 Deloris 	F
 Delpha 	F
 Delphia 	F
 Delphine 	F
 Delray 	M
 Delrick 	M
 Delrico 	M
 Delron 	M
 Delroy 	M
 Delsin 	M
 Delta 	F
 Delton 	M
 Delvin 	M
 Delvon 	M
 Delyssa 	F
 Deman 	M
 Demarco 	M
 Demarcus 	M
 Demario 	M
 Demason 	M
 Demasone 	M
 Demelza 	F
 Demetria 	F
 Demetrius 	M
 Demi 	F
 Demissie 	M
 Demond 	M
 Demothi 	M
 Dempsey 	M
 Dempster 	M
 Dena 	F
 Denby 	M
 Dene 	M
 Deneen 	F
 Denia 	F
 Denica 	F
 Denice 	F
 Deniece 	F
 Denis 	M
 Denisa 	F
 Denisc 	M
 Denise 	F
 Denisha 	F
 Denissa 	F
 Denisse 	F
 Denley 	M
 Dennet 	M
 Denney 	M
 Denni 	F
 Dennie 	M
 Dennis 	M
 Dennise 	F
 Dennison 	M
 Denny 	M
 Denton 	M
 Denver 	M
 Denys 	M
 Denyse 	F
 Denzel 	M
 Denzell 	M
 Denzil 	M
 Deoch 	F
 Deogol 	M
 Deon 	M
 Deona 	F
 Deondra 	F
 Deondre 	M
 Deonna 	F
 Deonne 	F
 Deontae 	M
 Deonte 	M
 Deoradhain 	M
 Deortun 	M
 Deorward 	M
 Deorwine 	M
 Dequan 	M
 Derald 	M
 Derebourne 	M
 Dereck 	M
 Derek 	M
 Dereka 	F
 Derell 	M
 Derforgal 	F
 Derforgala 	F
 Derian 	M
 Deric 	M
 Derica 	F
 Derick 	M
 Dericka 	F
 Derik 	M
 Dermod 	M
 Dermot 	M
 Deron 	M
 Derora 	F
 Derorice 	F
 Derorit 	F
 Derrall 	M
 Derrance 	M
 Derrek 	M
 Derrell 	M
 Derren 	M
 Derrian 	M
 Derrica 	F
 Derrick 	M
 Derrik 	M
 Derrill 	M
 Derrin 	M
 Derrold 	M
 Derry 	M
 Derryl 	M
 Derval 	F
 Dervilia 	F
 Dervin 	M
 Dervla 	F
 Dervon 	M
 Dervorgilla 	F
 Derwan 	M
 Derward 	M
 Derwent 	M
 Derwin 	M
 Derwyn 	M
 Deryck 	M
 Deryk 	M
 Des 	M
 Desarae 	F
 Desaree 	F
 Deshaun 	M
 Deshawn 	M
 Desideria 	F
 Desiderio 	M
 Desirae 	F
 Desirat 	F
 Desire 	M
 Desiree 	F
 Desmond 	M
 Dessa 	F
 Dessie 	F
 Desta 	M
 Destan 	M
 Destanee 	F
 Destin 	M
 Destina 	F
 Destine 	F
 Destinee 	F
 Destiney 	F
 Destini 	F
 Destinie 	F
 Destiny 	F
 Deston 	M
 Destrey 	M
 Destrie 	M
 Destry 	M
 Desyre 	F
 Deutsch 	M
 Dev 	M
 Deva 	F
 Devan 	M
 Devana 	F
 Devaney 	F
 Devanie 	F
 Devanna 	F
 Devante 	M
 Devany 	F
 Deven 	M
 Devenny 	F
 Devent 	F
 Deveon 	M
 Devera 	F
 Deveral 	M
 Devere 	M
 Devereau 	M
 Devereaux 	M
 Deverel 	M
 Deverell 	M
 Deverick 	M
 Devery 	M
 Devi 	F
 Devin 	M
 Devine 	M
 Devinee 	F
 Devion 	M
 Devisser 	M
 Devland 	M
 Devlin 	M
 Devlon 	M
 Devlyn 	M
 Devnet 	F
 Devon 	M
 Devona 	F
 Devondra 	F
 Devonn 	M
 Devonna 	F
 Devonne 	F
 Devonta 	M
 Devontae 	M
 Devonte 	M
 Devony 	F
 Devora 	F
 Devorah 	F
 Devoria 	F
 Devra 	F
 Devri 	F
 Devron 	M
 Devry 	M
 Devyn 	F
 Devyna 	F
 Devynn 	F
 Dewain 	M
 Dewayne 	M
 Dewey 	M
 Dewitt 	M
 Dexter 	M
 Deylin 	M
 Deysi 	F
 Dezirae 	F
 Deziree 	F
 Dhoire 	M
 Diahann 	F
 Diahna 	F
 Diamanda 	F
 Diamanta 	F
 Diamante 	F
 Diamond 	F
 Diamonique 	F
 Diamont 	M
 Diamontina 	F
 Dian 	F
 Diana 	F
 Dianda 	F
 Diandra 	F
 Diandre 	M
 Diane 	F
 Diann 	F
 Dianna 	F
 Diannah 	F
 Dianne 	F
 Diantha 	F
 Diara 	M
 Dichali 	M
 Dicie 	F
 Dick 	M
 Dickie 	M
 Dickson 	M
 Didier 	M
 Didrika 	F
 Diederich 	M
 Diedre 	F
 Diedrick 	M
 Diega 	F
 Diego 	M
 Diera 	F
 Dierck 	M
 Dierdre 	F
 Dieter 	M
 Dietrich 	M
 Dietz 	M
 Digna 	F
 Diji 	M
 Dikesone 	M
 Dilan 	M
 Dillan 	M
 Dillard 	M
 Dillen 	M
 Dillie 	F
 Dillion 	M
 Dillon 	M
 Dimitri 	M
 Dimple 	F
 Din 	M
 Dina 	F
 Dinadan 	M
 Dinah 	F
 Dino 	M
 Dinora 	F
 Dinorah 	F
 Dinsmore 	M
 Dion 	M
 Diona 	F
 Diondra 	F
 Diondre 	M
 Dione 	F
 Dionis 	F
 Dionisa 	F
 Dionna 	F
 Dionne 	F
 Dionte 	M
 Dior 	F
 Dirk 	M
 Dita 	F
 Divone 	F
 Divsha 	F
 Divshah 	F
 Dix 	M
 Dixie 	F
 Dixon 	M
 Diya al din 	M
 Dnias 	M
 Doane 	M
 Doanna 	F
 Dobi 	M
 Doc 	M
 Docia 	F
 Dohosan 	M
 Dohtor 	F
 Doire 	M
 Doireann 	F
 Dolan 	M
 Dollie 	F
 Dolly 	F
 Dolores 	F
 Doloris 	F
 Dolorita 	F
 Dolph 	M
 Dolphus 	M
 Domenic 	M
 Domenica 	F
 Domenick 	M
 Domenico 	M
 Domenique 	F
 Domevlo 	M
 Domhnall 	M
 Domhnull 	M
 Dominga 	F
 Domingo 	M
 Dominic 	M
 Dominica 	F
 Dominick 	M
 Dominik 	M
 Dominique 	F
 Dominque 	F
 Domonique 	F
 Don 	M
 Dona 	F
 Donaghy 	M
 Donahue 	M
 Donal 	M
 Donald 	M
 Donall 	M
 Donat 	M
 Donata 	F
 Donatello 	M
 Donatien 	M
 Donato 	M
 Donavan 	M
 Donavon 	M
 Dondre 	M
 Donegan 	M
 Donel 	M
 Donell 	M
 Donella 	F
 Donelle 	F
 Donia 	F
 Donie 	F
 Donita 	F
 Donn 	M
 Donna 	F
 Donnachadh 	M
 Donnally 	M
 Donnan 	M
 Donnchadh 	M
 Donne 	M
 Donnel 	M
 Donnell 	M
 Donnelly 	M
 Donnie 	M
 Donny 	M
 Donogb 	M
 Donovan 	M
 Donta 	M
 Dontae 	M
 Dontay 	M
 Dontaye 	M
 Donte 	M
 Dontell 	M
 Dontrell 	M
 Donzel 	M
 Doon 	F
 Dor 	M
 D'or 	F
 Dora 	F
 Doran 	M
 Dorathy 	F
 Dorbeta 	F
 Dorcas 	F
 Dorcey 	F
 Dore 	F
 Doreen 	F
 Doreena 	F
 Doren 	M
 Dorene 	F
 Doretha 	F
 Dori 	F
 Dorian 	M
 Dorien 	M
 Dorinda 	F
 Dorine 	F
 Dorion 	M
 Doris 	F
 Dorit 	F
 Dorla 	F
 Dorman 	M
 Doro 	F
 Doron 	M
 Dorotea 	F
 Doroteia 	F
 Dorotha 	F
 Dorothea 	F
 Dorothee 	F
 Dorothy 	F
 Dorran 	M
 Dorrance 	M
 Dorrel 	M
 Dorrell 	M
 Dorren 	M
 Dorrin 	M
 Dorris 	F
 Dorsey 	M
 Dortha 	F
 Dorthy 	F
 Dory 	F
 Dosha 	F
 Doshia 	F
 Doshie 	F
 Dosne 	M
 Doss 	M
 Dottie 	F
 Doug 	M
 Dougal 	M
 Doughal 	M
 Doughall 	M
 Doughlas 	M
 Douglas 	M
 Douglass 	M
 Doune 	M
 Dour 	M
 Dov 	M
 Dovev 	M
 Dovie 	F
 Dow 	M
 Dowan 	M
 Dowle 	M
 Downeti 	F
 Downett 	F
 Doy 	M
 Doyle 	M
 Draca 	M
 Dracon 	M
 Drago 	M
 Drake 	M
 Draven 	M
 Drayce 	M
 Dreena 	F
 Drefan 	M
 Drem 	M
 Dreng 	M
 Dreogan 	M
 Dridan 	M
 Driden 	M
 Drina 	F
 Driscol 	M
 Driscoll 	M
 Driskell 	M
 Dristan 	M
 Dru 	M
 Druce 	M
 Drucilla 	F
 Drud 	M
 Drudwyn 	M
 Drue 	M
 Drugi 	M
 Drummand 	M
 Drummond 	M
 Drusilla 	F
 Dryden 	M
 Drygedene 	M
 Drystan 	M
 Duana 	F
 Duane 	M
 Duante 	M
 Duardo 	M
 Duarte 	M
 Duayna 	F
 Duayne 	M
 Dubg 	M
 Dubh 	M
 Dubhagain 	M
 Dubhain 	F
 Dubhan 	M
 Dubheasa 	F
 Dubhglas 	M
 DubhgMl 	M
 Dubv 	M
 Dudley 	M
 Duena 	F
 Duer 	M
 Duff 	M
 Duffy 	M
 Duggan 	M
 Dughall 	M
 Duke 	M
 Dukine 	F
 Dukinea 	F
 Dulce 	F
 Dulcie 	F
 Dulcina 	F
 Dulcinea 	F
 Dulcinia 	F
 Dumont 	M
 Duncan 	M
 Dunham 	M
 Dunleah 	M
 Dunleigh 	M
 Dunley 	M
 Dunly 	M
 Dunmor 	M
 Dunmore 	M
 Dunn 	M
 Dunstan 	M
 Dunton 	M
 Duran 	M
 Durand 	M
 Durango 	M
 Durant 	M
 Durante 	M
 Dureau 	M
 Durell 	M
 Duron 	M
 Durrant 	M
 Durrell 	M
 Durward 	M
 Durwin 	M
 Durwood 	M
 Durwyn 	M
 Dustan 	M
 Dustee 	F
 Dusti 	F
 Dustin 	M
 Duston 	M
 Dustyn 	M
 Dutch 	M
 Duval 	M
 Duvessa 	F
 Duwayne 	M
 Dwade 	M
 Dwain 	M
 Dwaine 	M
 Dwane 	M
 Dwayne 	M
 Dwight 	M
 Dwyer 	M
 Dyami 	M
 Dyana 	F
 Dyani 	F
 Dyann 	F
 Dyanna 	F
 Dyfed 	M
 Dylan 	M
 Dylon 	M
 Dymphna 	F
 Dympna 	F
 Dynadin 	M
 Dynah 	F
 Dzigbode 	M
 Eachan 	M
 Eacnung 	F
 Eada 	F
 Eadaion 	F
 Eadbeorht 	M
 Eadbert 	M
 Eadburt 	M
 Eadda 	F
 Eadelmarr 	M
 Eadgard 	M
 Eadger 	M
 Eadgyth 	F
 Eadig 	M
 Eadignes 	F
 Eadlin 	F
 Eadlyn 	M
 Eadmund 	M
 Eadric 	M
 Eadsele 	M
 Eadward 	M
 Eadwardsone 	M
 Eadweald 	M
 Eadweard 	M
 Eadwiella 	M
 Eadwine 	M
 Eadwyn 	M
 Eagan 	M
 Eagon 	M
 Ealdian 	M
 Ealdun 	M
 Ealdwode 	M
 Ealga 	F
 Ealhdun 	M
 Ealhhard 	M
 Eallard 	M
 Eallison 	M
 Eames 	M
 Eamon 	M
 Ean 	M
 Eanruig 	M
 Eara 	F
 Earc 	M
 Earh 	M
 Earie 	M
 Earl 	M
 Earle 	M
 Earlean 	F
 Earlena 	F
 Earlene 	F
 Earlie 	M
 Earlina 	F
 Earline 	F
 Earm 	M
 Earna 	F
 Earnan 	M
 Earnest 	M
 Earnestine 	F
 Earnestyna 	F
 Earric 	F
 Eartha 	F
 Earvin 	M
 Earwine 	M
 Earwyn 	M
 Earwyna 	F
 Easton 	M
 Eastre 	F
 Eathelin 	F
 Eathellreda 	F
 Eathelyn 	F
 Eaton 	M
 Eatun 	M
 Eavan 	F
 Eawart 	M
 Eban 	M
 Ebb 	M
 Ebba 	F
 Eben 	M
 Ebenezer 	M
 Eber 	M
 Eberhard 	M
 Eberhardt 	M
 Eboni 	F
 Ebony 	F
 Eburhardt 	M
 Eburscon 	M
 Ecgbeorht 	M
 Ecgfrith 	M
 Eckerd 	M
 Ector 	M
 Eda 	F
 Edan 	M
 Edana 	F
 Edbert 	M
 Edd 	M
 Edda 	F
 Eddie 	M
 Eddis 	M
 Eddison 	M
 Eddrick 	M
 Eddy 	M
 Ede 	M
 Edee 	F
 Edeen 	F
 Edel 	M
 Edelina 	F
 Edeline 	F
 Edelmar 	M
 Edelmarr 	M
 Eden 	F
 Edenia 	F
 Eder 	M
 Edet 	M
 Edgar 	M
 Edgard 	M
 Edgardo 	M
 Edie 	F
 Ediline 	F
 Edina 	F
 Edine 	F
 Edingu 	M
 Edison 	M
 Edita 	F
 Edith 	F
 Editha 	F
 Edla 	F
 Edlen 	F
 Edlin 	M
 Edlyn 	M
 Edlynn 	F
 Edlynne 	F
 Edmanda 	F
 Edmee 	F
 Edmon 	M
 Edmond 	M
 Edmonda 	F
 Edmondo 	M
 Edmonia 	F
 Edmund 	M
 Edmunda 	F
 Edmundo 	M
 Edna 	F
 Edoardo 	M
 Edra 	F
 Edrea 	F
 Edred 	M
 Edric 	M
 Edrick 	M
 Edrie 	F
 Edrik 	M
 Edris 	F
 Edrys 	F
 Edsel 	M
 Edson 	M
 Eduard 	M
 Eduarda 	F
 Eduardo 	M
 Edvard 	M
 Edwald 	M
 Edwaldo 	M
 Edward 	M
 Edwardo 	M
 Edwardson 	M
 Edwin 	M
 Edwina 	F
 Edwinna 	F
 Edwy 	M
 Edwyn 	M
 Edyt 	F
 Edyth 	F
 Edytha 	F
 Edythe 	F
 Eeva 	F
 Eferhard 	M
 Eferhild 	F
 Eferhilda 	F
 Eferleah 	M
 Effa 	F
 Effie 	F
 Effiom 	M
 Efia 	F
 Efnisien 	M
 Efraim 	M
 Efrain 	M
 Efran 	M
 Efrat 	M
 Efrayim 	M
 Efrem 	M
 Efren 	M
 Efron 	M
 Egan 	M
 Egbert 	M
 Egberta 	F
 Egbertina 	F
 Egbertine 	F
 Egbertyne 	F
 Egerton 	M
 Egesa 	M
 Egeslic 	M
 Eghan 	M
 Egidio 	M
 Eginhard 	M
 Eginhardt 	M
 Eglantina 	F
 Eglantine 	F
 Egon 	M
 Ehren 	M
 Eibhear 	M
 Eibhlhin 	F
 Eideard 	M
 Eila 	F
 Eileen 	F
 Eileene 	F
 Eilena 	F
 Eilene 	F
 Eilig 	M
 Eilinora 	F
 Eilis 	F
 Eily 	F
 Eimar 	M
 Eimhin 	M
 Einar 	M
 Einhard 	M
 Einhardt 	M
 Einion 	M
 Eino 	M
 Eiric 	F
 Eirica 	F
 Eisa 	M
 Eistir 	F
 Eithna 	F
 Eithne 	F
 Ejnar 	M
 Ekerd 	M
 Ekhard 	M
 Ektor 	M
 Elaina 	F
 Elaine 	F
 Elam 	M
 Elan 	M
 Elayna 	F
 Elayne 	F
 Elazar 	M
 Elazaro 	M
 Elbert 	M
 Elberta 	F
 Elberte 	F
 Elbertina 	F
 Elbertine 	F
 Elbertyna 	F
 Elda 	F
 Eldan 	M
 Elden 	M
 Eldon 	M
 Eldora 	F
 Eldred 	M
 Eldreda 	F
 Eldrian 	M
 Eldrick 	M
 Eldrid 	M
 Eldrida 	F
 Eldride 	F
 Eldridge 	M
 Eldur 	M
 Eldwin 	M
 Eldwyn 	M
 Eleadora 	F
 Eleanor 	F
 Eleanora 	F
 Eleanore 	F
 Elease 	F
 Eleazar 	M
 Electa 	F
 Eleena 	F
 Elena 	F
 Elene 	F
 Elenor 	F
 Elenora 	F
 Elenore 	F
 Eleonora 	F
 Eleonore 	F
 Eleora 	F
 Eleta 	F
 Elethea 	F
 Elethia 	F
 Elfie 	F
 Elfreda 	F
 Elfrida 	F
 Elfrieda 	F
 Elga 	F
 Elgin 	M
 Elgine 	M
 Elhanan 	M
 Eli 	M
 Elia 	M
 Elian 	M
 Eliana 	F
 Eliane 	F
 Elias 	M
 Eliazar 	M
 Elica 	F
 Elicia 	F
 Elida 	F
 Elidor 	M
 Elie 	M
 Elienor 	F
 Eliezer 	M
 Eliga 	M
 Eligah 	M
 Elige 	M
 Elihu 	M
 Elija 	M
 Elijah 	M
 Elimu 	M
 Elina 	F
 Elinor 	F
 Elinore 	F
 Eliora 	F
 Eliot 	M
 Eliott 	M
 Elisa 	F
 Elisabet 	F
 Elisabeth 	F
 Elisabetta 	F
 Elisamarie 	F
 Elisavet 	F
 Elisaveta 	F
 Elise 	F
 Eliseo 	M
 Elisha 	F
 Elishama 	M
 Elisheba 	M
 Elisheva 	M
 Elishia 	F
 Elissa 	F
 Elita 	F
 Elivina 	F
 Eliza 	F
 Elizabeth 	F
 Elizaveta 	F
 Elizebeth 	F
 Eljin 	M
 Elka 	F
 Elkanah 	M
 Elke 	F
 Ella 	F
 Ellaine 	F
 Ellar 	F
 Ellard 	M
 Ellayne 	F
 Ellder 	M
 Elle 	F
 Ellecia 	F
 Ellee 	F
 Elleen 	F
 Ellen 	F
 Ellena 	F
 Ellene 	F
 Ellenweorc 	F
 Ellery 	M
 Ellesse 	F
 Ellette 	F
 Elli 	F
 Ellia 	F
 Ellice 	F
 Ellie 	F
 Ellinor 	F
 Elliot 	M
 Elliott 	M
 Ellis 	M
 Ellisha 	F
 Ellison 	M
 Elliston 	M
 Ellsworth 	M
 Ellwood 	M
 Elly 	F
 Ellyce 	F
 Ellyn 	F
 Elma 	F
 Elmer 	M
 Elmira 	F
 Elmo 	M
 Elmoor 	M
 Elmore 	M
 Elmyra 	F
 Elna 	F
 Elne 	M
 Elnora 	F
 Elois 	F
 Eloisa 	F
 Eloise 	F
 Eloisee 	F
 Elora 	F
 Elouise 	F
 Eloy 	M
 Elrad 	M
 Elric 	M
 Elrick 	M
 Elrod 	M
 Elroy 	M
 Els 	F
 Elsa 	F
 Elsbeth 	F
 Elsdon 	M
 Elsha 	F
 Elsie 	F
 Elsje 	F
 Elson 	M
 Elspeth 	F
 Elston 	M
 Elsu 	M
 Elsworth 	M
 Elswyth 	F
 Elta 	F
 Elthia 	F
 Elton 	M
 Eluwilussit 	M
 Elva 	F
 Elvena 	F
 Elvera 	F
 Elvern 	M
 Elvey 	M
 Elvia 	F
 Elvie 	F
 Elvin 	M
 Elvina 	F
 Elvine 	F
 Elvinia 	F
 Elvio 	M
 Elvira 	F
 Elvis 	M
 Elvita 	F
 Elvy 	M
 Elvyn 	M
 Elvyne 	F
 Elwald 	M
 Elwell 	M
 Elwen 	M
 Elwin 	M
 Elwine 	F
 Elwold 	M
 Elwood 	M
 Elwyn 	M
 Elwyna 	F
 Ely 	M
 Elyce 	F
 Elynn 	F
 Elyse 	F
 Elyssa 	F
 Elyta 	F
 Elyza 	F
 Elza 	M
 Elzie 	M
 Elzira 	F
 Ema 	F
 Eman 	M
 Emanuel 	M
 Ember 	F
 Emelia 	F
 Emelie 	F
 Emeline 	F
 Emely 	F
 Emerald 	F
 Emeraude 	F
 Emerson 	M
 Emery 	M
 Emest 	M
 Emesta 	F
 Emestina 	F
 Emestine 	F
 Emesto 	M
 Emil 	M
 Emile 	M
 Emilee 	F
 Emilia 	F
 Emiliano 	M
 Emilie 	F
 Emilio 	M
 Emily 	F
 Emma 	F
 Emmalee 	F
 Emmaline 	F
 Emmalyn 	F
 Emmanuel 	M
 Emmanuele 	M
 Emmanuella 	F
 Emmanuelle 	F
 Emmeline 	F
 Emmer 	F
 Emmet 	M
 Emmett 	M
 Emmie 	F
 Emmit 	M
 Emmitt 	M
 Emmy 	F
 Emogene 	F
 Emory 	M
 Emrys 	M
 Emst 	M
 Emunah 	F
 Ena 	F
 Enando 	M
 Enapay 	M
 Enat 	F
 Encarnacion 	F
 Enda 	M
 Enea 	M
 Eneas 	M
 Enerstina 	F
 Enerstyne 	F
 Engel 	M
 Engelbertha 	F
 Engelbertina 	F
 Engelbertine 	F
 Engl 	F
 Englbehrt 	M
 Englebert 	M
 Engleberta 	F
 Engracia 	F
 Engres 	M
 Enid 	F
 Enide 	F
 Enit 	F
 Enite 	F
 Enkoodabaoo 	M
 Enkoodabooaoo 	M
 Ennis 	M
 Enno 	M
 Eno 	M
 Enoch 	M
 Enola 	F
 Enos 	M
 Enrica 	F
 Enrice 	F
 Enrichetta 	F
 Enrico 	M
 Enriqua 	F
 Enrique 	M
 Enriqueta 	F
 Eny 	F
 Enyd 	F
 Enyeto 	M
 Enygeus 	F
 Enzo 	M
 Eoforwic 	M
 Eoghan 	M
 Eoghann 	M
 Eoin 	M
 Eoin Baiste 	M
 Eorl 	M
 Eorland 	M
 Eorlland 	M
 Eorlson 	M
 Eostre 	F
 Ephraim 	M
 Ephram 	M
 Ephrem 	M
 Ephriam 	M
 Ephron 	M
 Eraman 	F
 Eramana 	F
 Eran 	M
 Erasmo 	M
 Erasto 	M
 Erastus 	M
 Erc 	M
 Erchanbold 	M
 Erchanhardt 	M
 Erea 	F
 Erek 	M
 Erela 	F
 Erelah 	F
 Erendira 	F
 Erendiria 	F
 Ereonberht 	M
 Erhard 	M
 Erhardt 	M
 Eri 	M
 Erian 	M
 Eric 	M
 Erica 	F
 Erich 	M
 Erick 	M
 Ericka 	F
 Erie 	F
 Erik 	M
 Erika 	F
 Erin 	F
 Erina 	F
 Eriq 	M
 Eris 	F
 Erith 	F
 Eritha 	F
 Erkerd 	M
 Erland 	M
 Erle 	M
 Erleen 	F
 Erlene 	F
 Erlina 	F
 Erlinda 	F
 Erline 	F
 Erling 	M
 Erma 	F
 Ermanno 	M
 Erna 	F
 Ernesha 	F
 Ernest 	M
 Ernesta 	F
 Ernestina 	F
 Ernestine 	F
 Ernesto 	M
 Ernie 	M
 Ernst 	M
 Eron 	M
 Errapel 	M
 Errol 	M
 Erroll 	M
 Erskina 	F
 Erskine 	M
 Ertha 	F
 Ervin 	M
 Ervine 	M
 Erving 	M
 Erwin 	M
 Erwina 	F
 Erwyn 	M
 Erwyna 	F
 Eryn 	F
 Erzsebet 	F
 Esau 	M
 Escalibor 	M
 Escanor 	M
 Esdras 	M
 Esequiel 	M
 Eshe 	F
 Eshkol 	M
 Esi 	F
 Esiankiki 	F
 Esinam 	F
 Eskama 	F
 Eskame 	F
 Esma 	F
 Esme 	F
 Esmeralda 	F
 Esmeraude 	F
 Esmerelda 	F
 Esmond 	M
 Esmund 	M
 Espen 	M
 Esperanza 	F
 Esra 	M
 Esrlson 	M
 Essie 	F
 Esta 	F
 Estcot 	M
 Estcott 	M
 Este 	M
 Esteban 	M
 Estebana 	F
 Estee 	F
 Estefan 	M
 Estefana 	F
 Estefani 	F
 Estefania 	F
 Estefany 	F
 Estel 	M
 Estela 	F
 Estelita 	F
 Estell 	F
 Estella 	F
 Estelle 	F
 Estephanie 	F
 Ester 	F
 Esteva 	F
 Estevan 	M
 Estevon 	M
 Esther 	F
 Estmund 	M
 Eston 	M
 Estrela 	F
 Estrella 	F
 Estrellita 	F
 Eszter 	F
 Etain 	F
 Etan 	M
 Etchemin 	M
 Etel 	F
 Etenia 	F
 Eth 	M
 Etha 	F
 Ethan 	M
 Ethel 	F
 Ethelbald 	M
 Ethelbert 	M
 Ethelinda 	F
 Ethelinde 	F
 Ethelred 	M
 Ethelreda 	F
 Ethelwulf 	M
 Ethelyn 	F
 Ethen 	M
 Etheswitha 	F
 Ethna 	F
 Ethne 	F
 Ethyl 	F
 Etienne 	M
 Etilka 	F
 Etlelooaat 	M
 Etna 	F
 Etney 	F
 Etta 	F
 Ettard 	F
 Ettare 	F
 Ettie 	F
 Ettore 	M
 Etty 	F
 Etu 	M
 Euan 	M
 Eudora 	F
 Eugen 	M
 Eugene 	M
 Eugenia 	F
 Eugenie 	F
 Eugenio 	M
 Eugenius 	M
 Eula 	F
 Eulah 	F
 Eulalia 	F
 Eulalie 	F
 Euna 	F
 Eunice 	F
 Euphemia 	F
 Eura 	F
 Eustatius 	M
 Eva 	F
 Evacska 	F
 Evadeam 	M
 Evalac 	M
 Evaleen 	F
 Evalena 	F
 Evalina 	F
 Evaline 	F
 Evalyn 	F
 Evan 	M
 Evanee 	F
 Evangelina 	F
 Evangeline 	F
 Evania 	F
 Evanna 	F
 Evans 	M
 Evarado 	M
 Evelake 	M
 Eveleen 	F
 Evelin 	F
 Evelina 	F
 Eveline 	F
 Evelyn 	F
 Evelyne 	F
 Evelynn 	F
 Evelynne 	F
 Everard 	M
 Everardo 	M
 Everet 	M
 Everett 	M
 Everette 	M
 Everhard 	M
 Everhart 	M
 Everleigh 	M
 Everley 	M
 Everly 	M
 Evert 	M
 Everton 	M
 Evetta 	F
 Evette 	F
 Evia 	F
 Evian 	M
 Eviana 	F
 Evie 	F
 Evika 	F
 Evike 	F
 Evin 	M
 Evina 	F
 Evita 	F
 Evon 	F
 Evonna 	F
 Evonne 	F
 Evony 	F
 Evoy 	M
 Evrain 	M
 Evrard 	M
 Ewa 	F
 Ewald 	M
 Ewan 	M
 Eward 	M
 Ewart 	M
 Eweheorde 	M
 Ewell 	M
 Ewen 	M
 Ewert 	M
 Ewing 	M
 Ewyn 	M
 Exaltacion 	F
 Excalibur 	M
 Exie 	F
 Eyota 	F
 Eyou 	M
 Ezechiel 	M
 Ezeji 	M
 Ezekiel 	M
 Ezell 	M
 Ezequiel 	M
 Ezhno 	M
 Ezmeralda 	F
 Ezra 	M
 Ezrah 	M
 Faber 	M
 Fabian 	M
 Fabiana 	F
 Fabiano 	M
 Fabien 	M
 Fabienne 	F
 Fabio 	M
 Fabiola 	F
 Fabion 	M
 Fabrizio 	M
 Fabroni 	M
 Fachnan 	M
 Fadil 	M
 Fadilah 	F
 Fae 	F
 Faegan 	M
 Faer 	M
 Faerrleah 	M
 Faerwald 	M
 Fagan 	M
 Fahey 	M
 Fahy 	M
 Fai 	M
 FaIIon 	M
 Fainche 	F
 Faine 	M
 Faing 	M
 Fairfax 	M
 Fairlie 	M
 Fairy 	F
 Faithe 	F
 Fakhir 	M
 Fala 	F
 Falcon 	M
 Faline 	F
 Falk 	M
 Falke 	M
 Falken 	M
 Fallamhain 	M
 Fallon 	F
 Fallyn 	F
 Falon 	F
 Fana 	F
 Fanceen 	F
 Fanchon 	F
 Fanchone 	F
 Fane 	M
 Fanetta 	F
 Fanette 	F
 Fang 	M
 Fang Yin 	F
 Fanni 	F
 Fannia 	F
 Fannie 	F
 Fanny 	F
 Fanta 	F
 Fantina 	F
 Fantine 	F
 Fanuco 	M
 Faoiltiama 	F
 Faolan 	M
 Faqueza 	F
 Fara 	F
 Farah 	F
 Faraji 	M
 Faran 	M
 Fardoragh 	M
 Faren 	F
 Farid 	M
 Faridah 	F
 Farin 	F
 Faris 	M
 Farlan 	M
 Farlane 	M
 Farleigh 	M
 Farley 	M
 Farlow 	M
 Farly 	M
 Farmon 	M
 Farnall 	M
 Farnell 	M
 Farnham 	M
 Farnly 	M
 Faro 	M
 Farold 	M
 Faron 	M
 Farquharson 	M
 Farr 	M
 Farrah 	F
 Farran 	M
 Farrel 	M
 Farrell 	M
 Farren 	M
 Farrin 	M
 Farris 	M
 Farron 	F
 Farrs 	M
 Farry 	M
 Farryn 	F
 Fars 	M
 Farson 	M
 Faruq 	M
 Faryn 	F
 Fatima 	F
 Fatimah 	F
 Fatin 	M
 Fatina 	F
 Fatinah 	F
 Fatuma 	F
 Faunia 	F
 Fausta 	F
 Faustina 	F
 Fausto 	M
 Favian 	M
 Favio 	M
 Fawna 	F
 Fawne 	F
 Fawnia 	F
 Fay 	F
 Fayanna 	F
 Faye 	F
 Fayette 	M
 Fayme 	F
 Fayne 	M
 Fayola 	F
 Fayre 	F
 Fayth 	F
 Feandan 	M
 Fearchar 	M
 Fearchara 	F
 Fearcharia 	F
 Fearghus 	M
 Fearnhamm 	M
 Fearnhealh 	M
 Fearnleah 	M
 Fedelm 	F
 Federico 	M
 Federikke 	F
 Feenat 	F
 Feich 	M
 Feirefiz 	M
 Fela 	M
 Felabeorbt 	M
 Felabeorht 	F
 Felamaere 	M
 Felan 	M
 Felberta 	F
 Felda 	F
 Felding 	M
 Feldon 	M
 Feldtun 	M
 Feldun 	M
 Felecia 	F
 Felicia 	F
 Feliciano 	M
 Felicienne 	F
 Felicita 	F
 Felicitas 	F
 Felicity 	F
 Felipe 	M
 Felippe 	M
 Felisa 	F
 Felisberta 	F
 Felisha 	F
 Felix 	M
 Felton 	M
 Fenella 	F
 Feng 	F
 F'enton 	M
 Feran 	M
 Ferd 	M
 Ferdinand 	M
 Ferdinando 	M
 Ferehar 	M
 Ferghus 	M
 Fergus 	M
 Ferguson 	M
 Fergusson 	M
 Fermin 	M
 Fermina 	F
 Fern 	F
 Fernald 	M
 Fernand 	M
 Fernanda 	F
 Fernando 	M
 Ferne 	F
 Ferran 	M
 Ferrell 	M
 Ferris 	M
 Ferron 	M
 Ferryn 	F
 Fia 	F
 Fiacra 	M
 Fiacre 	M
 Fianait 	F
 Fianna 	F
 FIannan 	M
 Fibh 	M
 Fidel 	M
 Fidele 	M
 Fidelio 	M
 Fidelma 	F
 Fie 	M
 Fielding 	M
 Fifi 	F
 Fifine 	F
 Fifna 	F
 Fifne 	F
 Filbert 	M
 Filberta 	F
 Filbuk 	M
 Filicia 	F
 Filipa 	F
 Filippina 	F
 Filippo 	M
 Filmarr 	M
 Filmer 	M
 Filmore 	M
 Filomena 	F
 Fina 	F
 Finan 	M
 Finbar 	M
 Findabair 	F
 Fineen 	M
 Fineena 	F
 Finella 	F
 Finghin 	M
 Fingula 	F
 Finian 	M
 Finis 	M
 Finley 	M
 Finn 	M
 Finna 	F
 Finnbar 	M
 Finneen 	M
 Finnegan 	M
 Finnin 	M
 Finnobarr 	M
 Finola 	F
 Fiona 	F
 Fionan 	M
 Fionn 	M
 Fionna 	F
 Fionnbarr 	M
 Fionnghuala 	F
 Fionnuala 	F
 Fiorello 	M
 Fiorenza 	F
 Firman 	M
 Firth 	M
 Firtha 	F
 Fiske 	M
 Fitch 	M
 Fitche 	M
 Fitz 	M
 Fitz Adam 	M
 Fitz Gerald 	M
 Fitz Gibbon 	M
 Fitz Gilbert 	M
 Fitz Hugh 	M
 Fitz James 	M
 Fitz Patrick 	M
 Fitz Simon 	M
 Fitz Walter 	M
 Fitz Water 	M
 Fitzadam 	M
 Fitzgerald 	M
 Fitzgibbon 	M
 Fitzgilbert 	M
 Fitzhugh 	M
 Fitzjames 	M
 Fitzpatrick 	M
 Fitzsimmons 	M
 Fitzsimon 	M
 Fitzsimons 	M
 Fitzwalter 	M
 Fitzwater 	M
 FIynn 	M
 Flainn 	M
 Flair 	F
 Flanagan 	M
 Flann 	M
 Flanna 	F
 Flannagain 	M
 Flannagan 	M
 Flannery 	M
 Flavia 	F
 Flavio 	M
 Fleming 	M
 Fleta 	F
 Fletcher 	M
 Fleur 	F
 Fleurette 	F
 Flinn 	M
 Flint 	M
 Flo 	F
 Floinn 	M
 Flor 	F
 Flora 	F
 Florance 	F
 Florence 	F
 Florencia 	F
 Florene 	F
 Florentina 	F
 Florentino 	M
 Floressa 	F
 Floretta 	F
 Flori 	F
 Floria 	F
 Florian 	M
 Floriana 	F
 Florida 	F
 Florinda 	F
 Florine 	F
 Florinia 	F
 Florinio 	M
 Florita 	F
 Florrie 	F
 Florus 	M
 Flossie 	F
 Floy 	F
 Floyd 	M
 Flyn 	M
 Flynn 	M
 Flynt 	M
 Flyta 	F
 Fodjour 	M
 Fogartaigh 	M
 Fogarty 	M
 Fogerty 	M
 Fola 	F
 Foley 	M
 Foma 	M
 Fonda 	F
 Fonsie 	M
 Fonso 	M
 Fontaine 	M
 Fontane 	M
 Fontanne 	F
 Fontayne 	M
 Fonteyne 	M
 Fonzell 	M
 Fonzie 	M
 Fonzo 	M
 Forba 	M
 Forbes 	M
 Forbia 	F
 Ford 	M
 Forde 	M
 Forester 	M
 Forrest 	M
 Forrester 	M
 Fortun 	M
 Fortuna 	F
 Foster 	M
 Fowler 	M
 Foy 	M
 Fraco 	M
 Fraine 	M
 Fran 	F
 France 	F
 Francena 	F
 Francene 	F
 Frances 	F
 Francesca 	F
 Francesco 	M
 Franci 	F
 Francia 	F
 Francie 	F
 Francille 	F
 Francina 	F
 Francine 	F
 Francis 	M
 Francisca 	F
 Francisco 	M
 Franco 	M
 Francois 	M
 Francoise 	F
 Frank 	M
 Franki 	F
 Frankie 	M
 Franklin 	M
 Franklyn 	M
 Franky 	M
 Frantz 	M
 Franz 	M
 Franziska 	F
 Fraomar 	M
 Frasco 	M
 Frascuelo 	M
 Fraser 	M
 Frasier 	M
 Frayne 	M
 Frazer 	M
 Frazier 	M
 Freca 	M
 Fred 	M
 Freda 	F
 Fredda 	F
 Freddi 	F
 Freddie 	M
 Freddy 	M
 Frederic 	M
 Frederica 	F
 Frederick 	M
 Fredericka 	F
 Frederico 	M
 Frederik 	M
 Frederika 	F
 Fredric 	M
 Fredrick 	M
 Fredrika 	F
 Freeda 	F
 Freeland 	M
 Freeman 	M
 Freida 	F
 Freira 	F
 Freman 	M
 Fremont 	M
 Freowine 	M
 Fresco 	M
 Frescura 	F
 Frewen 	M
 Frewin 	M
 Frewyn 	M
 Frey 	M
 Freya 	F
 Freyne 	M
 Frick 	M
 Frida 	F
 Fridolf 	M
 Fridolph 	M
 Friduwulf 	M
 Fridwolf 	M
 Frieda 	F
 Friedrich 	M
 Friedrick 	M
 Frika 	M
 Frimunt 	M
 Frisa 	M
 Frisco 	M
 Fritz 	M
 Fritzi 	F
 Froille 	M
 Frollo 	M
 Frona 	F
 Fronia 	F
 Fronie 	F
 Fshd 	M
 Fugeltun 	M
 Fugol 	M
 Fulaton 	M
 Fullere 	M
 Fulton 	M
 Furman 	M
 Fyfa 	F
 Fyfe 	M
 Fynballa 	F
 Fynbar 	M
 Fyren 	M
 Fytch 	M
 Ga!l 	M
 Gaagii 	M
 Gaarwine 	M
 Gabe 	M
 Gabi 	M
 Gabino 	M
 Gabor 	M
 Gabrian 	M
 Gabriel 	M
 Gabriela 	F
 Gabriele 	M
 Gabriell 	F
 Gabriella 	F
 Gabrielle 	F
 Gabriello 	M
 Gabrielo 	M
 Gabrio 	M
 Gaby 	F
 Gace 	M
 Gad 	M
 Gaderian 	M
 Gadhra 	M
 Gadi 	M
 Gadiel 	M
 Gael 	M
 Gaelle 	F
 Gaetan 	M
 Gaetana 	F
 Gaetane 	F
 Gaetano 	M
 Gaffney 	M
 Gage 	M
 Gahariet 	M
 Gaheris 	M
 Gahmuret 	M
 Gaho 	F
 Gaige 	M
 Gail 	F
 Gaila 	F
 Gaile 	M
 Gair 	M
 Gaira 	F
 Gairbith 	M
 Gais 	M
 Gal 	M
 Gala 	F
 Galahad 	M
 Galahalt 	M
 Galahault 	M
 Galan 	M
 Galantyne 	M
 Galatee 	F
 Galatyn 	M
 Galea 	F
 Galen 	M
 Galena 	F
 Galenia 	F
 Galenka 	F
 Galeno 	M
 Galeron 	M
 Galeun 	M
 Gali 	F
 Galia 	F
 Galiana 	F
 Galice 	F
 Galiena 	F
 Galiene 	F
 Galila 	F
 Galilah 	F
 Galilahi 	F
 Galilea 	F
 Galina 	F
 Galit 	F
 Gall 	M
 Galla 	F
 Gallagher 	M
 Gallia 	F
 Galochka 	F
 Galt 	M
 Galtero 	M
 Galton 	M
 Galvarium 	M
 Galvin 	M
 Galvyn 	M
 Galya 	F
 Gamaliel 	M
 Gana 	F
 Ganet 	F
 Ganice 	F
 Ganieda 	F
 Ganit 	F
 Gann 	M
 Gannon 	M
 Gar 	M
 Gara 	M
 Garabina 	F
 Garabine 	F
 Garaden 	M
 Garadin 	M
 Garadun 	M
 Garadyn 	M
 Garafeld 	M
 Garaitz 	F
 Garan 	M
 Garatun 	M
 Garberend 	M
 Garbhan 	M
 Garbina 	F
 Garbine 	F
 Garcia 	M
 Gard 	M
 Gardenia 	F
 Gardiner 	M
 Gardner 	M
 Gare 	M
 Gared 	M
 Garen 	M
 Garet 	M
 Gareth 	M
 Garett 	M
 Garey 	M
 Garfield 	M
 Garia 	F
 Gariland 	M
 Garin 	M
 Garion 	M
 Garlan 	M
 Garland 	M
 Garlen 	M
 Garlyn 	M
 Garman 	M
 Garmangahis 	F
 Garmann 	M
 Garmond 	M
 Garmund 	M
 Garnell 	M
 Garner 	M
 Garnet 	F
 Garnett 	M
 Garold 	M
 Garon 	M
 Garr 	M
 Garrad 	M
 Garran 	M
 Garrard 	M
 Garred 	M
 Garren 	M
 Garret 	M
 Garreth 	M
 Garrett 	M
 Garrey 	M
 Garrick 	M
 Garrin 	M
 Garrison 	M
 Garrity 	M
 Garrman 	M
 Garron 	M
 Garroway 	M
 Garrson 	M
 Garry 	M
 Garson 	M
 Garsone 	M
 Garth 	M
 Garton 	M
 Garvan 	M
 Garve 	M
 Garvey 	M
 Garvin 	M
 Garvyn 	M
 Garwig 	M
 Garwin 	M
 Garwood 	M
 Garwyn 	M
 Gary 	M
 Gascon 	M
 Gaspar 	M
 Gaspara 	F
 Gaspard 	M
 Gaston 	M
 Gaukroger 	M
 Gauthier 	M
 Gautier 	M
 Gauvain 	M
 Gavan 	M
 Gaven 	M
 Gavenia 	F
 Gavi 	M
 Gavin 	M
 Gavina 	F
 Gavra 	F
 Gavriel 	M
 Gavrila 	F
 Gavrilla 	F
 Gavyn 	M
 Gawain 	M
 Gawen 	M
 Gawyn 	M
 Gaye 	F
 Gayla 	F
 Gayle 	F
 Gaylen 	F
 Gaylene 	F
 Gaylon 	M
 Gaylord 	M
 Gaynell 	F
 Gazit 	F
 Gearld 	M
 Gearldine 	F
 Gearoid 	M
 Geary 	M
 Gechina 	F
 Gedaliah 	M
 Gedalya 	M
 Gedalyahu 	M
 Gedeon 	M
 Geela 	F
 Geffrey 	M
 Gehard 	M
 Geldersman 	M
 Gelsomina 	F
 Gemma 	F
 Gena 	F
 Genaro 	M
 Genaya 	F
 Generosa 	F
 Generosb 	M
 Genesis 	F
 Genessa 	F
 Geneva 	F
 Geneve 	F
 Genevie 	F
 Genevieve 	F
 Genevra 	F
 Genevre 	F
 Genie 	F
 Genisa 	F
 Genisia 	F
 Genisis 	F
 Genivee 	F
 Genna 	F
 Genny 	F
 Genoveva 	F
 Genowefa 	F
 Geo 	M
 Geoff 	M
 Geoffrey 	M
 Geol 	M
 Geomar 	M
 Georg 	M
 George 	M
 Georgeann 	F
 Georgene 	F
 Georgetta 	F
 Georgette 	F
 Georgia 	F
 Georgiana 	F
 Georgianna 	F
 Georgie 	F
 Georgina 	F
 Georgine 	F
 Georgio 	M
 Georgitte 	F
 Geraghty 	M
 Geraint 	M
 Gerald 	M
 Geraldina 	F
 Geraldine 	F
 Geraldo 	M
 Geralt 	M
 Geralyn 	F
 Geralynn 	F
 Gerard 	M
 Gerardo 	M
 Gerd 	M
 Gerda 	F
 Gerde 	F
 Gerdie 	F
 Gere 	M
 Geremia 	M
 Gerhard 	M
 Gerhardina 	F
 Gerhardine 	F
 Geri 	F
 Gerica 	F
 Gericka 	F
 Gerika 	F
 Gerlach 	M
 Germain 	M
 Germaine 	F
 German 	M
 Germana 	F
 Germano 	M
 Gerold 	M
 Geron 	M
 Geronimo 	M
 Gerrald 	M
 Gerrard 	M
 Gerred 	M
 Gerrell 	M
 Gerri 	F
 Gerrilyn 	F
 Gerrit 	M
 Gerry 	M
 Gersham 	M
 Gershom 	M
 Gertha 	F
 Gertie 	F
 Gertrud 	F
 Gertruda 	F
 Gertrude 	F
 Gertrudes 	F
 Gertrudis 	F
 Gertrut 	F
 Gervase 	M
 Gervasio 	M
 Gervaso 	M
 Gerwalt 	F
 Gerwalta 	F
 Getachew 	M
 Geteye 	M
 Gezana 	F
 Gezane 	F
 Ghedi 	M
 Gherardo 	M
 Ghislain 	M
 Ghislaine 	F
 Gia 	F
 Giacomo 	M
 Gian 	M
 Giana 	F
 Giancarlo 	M
 Gianina 	F
 Gianna 	F
 Giannes 	M
 Gianni 	M
 Gibbesone 	M
 Gibson 	M
 Gideon 	M
 Gifford 	M
 Giflet 	M
 Gifre 	M
 Gifuhard 	M
 Gigi 	F
 Gijs 	M
 Gikhrist 	M
 Gil 	M
 Gila 	F
 Gilah 	F
 Gilal 	F
 Gilala 	F
 Gilana 	F
 Gilat 	F
 Gilbarta 	F
 Gilbert 	M
 Gilberta 	F
 Gilberto 	M
 Gilbride 	M
 Gilburt 	M
 Gilda 	F
 Gildan 	F
 Gildas 	M
 Gildea 	M
 Giles 	M
 Gilford 	M
 Gili 	M
 Gilia 	F
 Gilibeirt 	M
 Gilit 	F
 Gilleabart 	M
 Gilleasbuig 	M
 Gillecriosd 	M
 Gillermo 	M
 Gilley 	M
 Gilli 	M
 Gillian 	F
 Gillivray 	M
 Gilmar 	M
 Gilmat 	M
 Gilmer 	M
 Gilmore 	M
 Gilpin 	M
 Gilroy 	M
 Gilvarry 	M
 Gimm 	M
 Gina 	F
 Ginebra 	F
 Ginerva 	F
 Ginessa 	F
 Ginna 	F
 Ginnette 	F
 Ginnie 	F
 Ginny 	F
 Gino 	M
 Giolla Chriost 	M
 Giollabrighde 	M
 Giollabuidhe 	M
 Giolladhe 	M
 Giomar 	M
 Giorgio 	M
 Giovani 	M
 Giovanna 	F
 Giovanni 	M
 Giovanny 	M
 Gipsy 	F
 Girflet 	M
 Gisa 	F
 Gisela 	F
 Giselbert 	M
 Gisele 	F
 Gisella 	F
 Giselle 	F
 Giselmaere 	M
 Gisilberhta 	F
 Gisselle 	F
 Gitana 	F
 Githa 	F
 Gitta 	F
 Giuliano 	M
 Giulio 	M
 Giuseppe 	M
 GIynna 	F
 Giza 	F
 Gjerta 	F
 Gladwin 	M
 Gladwyn 	M
 Gladys 	F
 Glaedwine 	M
 Glais 	M
 Glaleanna 	M
 Gleda 	F
 Glen 	M
 Glenda 	F
 Glendon 	M
 Glenn 	M
 Glenna 	F
 Glennie 	F
 Glifieu 	M
 Glinda 	F
 Gliona 	F
 Gloria 	F
 Gloriana 	F
 Gloriane 	F
 Glorianna 	F
 Glover 	M
 Glyn 	M
 Glynda 	F
 Glynis 	F
 Glynn 	M
 Gobha 	M
 Gobinet 	F
 Gobnait 	F
 Gobnat 	F
 Godalupe 	F
 Goddard 	M
 Godewyn 	M
 Godfredo 	M
 Godfrey 	M
 Godgifu 	F
 Godiva 	F
 Godofredo 	M
 Godric 	M
 Godwin 	M
 Godwine 	M
 Gofraidh 	M
 Gofried 	M
 Gogarty 	M
 Gogo 	M
 Golda 	F
 Goldia 	F
 Goldie 	F
 Golds 	F
 Goldwin 	M
 Goldwine 	M
 Goldwyn 	M
 Goldy 	F
 Golligan 	M
 Gonzalo 	M
 Goodwin 	M
 Goodwine 	M
 Goodwyn 	M
 Goraidh 	M
 Gorane 	F
 Gordain 	M
 Gordan 	M
 Gordana 	F
 Gordania 	F
 Gordie 	M
 Gordon 	M
 Gordy 	M
 Gore 	M
 Gorlois 	M
 Gormain 	M
 Gorman 	M
 Gormghlaith 	F
 Gormley 	M
 Gormly 	F
 Gorre 	M
 Gorrie 	M
 Gorry 	M
 Gorsedd 	M
 Gorvenal 	M
 Gosheven 	M
 Gothfraidh 	M
 Gottfried 	M
 Gottlieb 	M
 Gotzone 	F
 Gouveniail 	M
 Govannon 	M
 Goveniayle 	M
 Gow 	M
 Gowan 	M
 Gowyn 	M
 Grace 	F
 Gracia 	F
 Graciana 	F
 Gracie 	F
 Graciela 	F
 Graden 	M
 Gradon 	M
 Grady 	M
 Graeghamm 	M
 Graegleah 	M
 Graeham 	M
 Graeme 	M
 Graent 	M
 Grafere 	M
 Graham 	M
 Grahem 	M
 Graine 	F
 Grainne 	F
 Gram 	M
 Granger 	M
 Grangere 	M
 Grania 	F
 Grant 	M
 Grantham 	M
 Grantland 	M
 Grantley 	M
 Granville 	M
 Gray 	M
 Grayce 	F
 Graysen 	M
 Grayson 	M
 Grayvesone 	M
 Grazia 	F
 Grazina 	F
 Grazinia 	F
 Grazyna 	F
 Greagoir 	M
 Greeley 	M
 Greely 	M
 Green 	M
 Greg 	M
 Gregg 	M
 Greggory 	M
 Gregor 	M
 Gregoria 	F
 Gregorio 	M
 Gregory 	M
 Gregos 	M
 Gregson 	M
 Gremian 	M
 Grendel 	M
 Grenville 	M
 Gresham 	M
 Greta 	F
 Gretchen 	F
 Gretel 	M
 Grey 	M
 Greyson 	M
 Gricelda 	F
 Griffith 	M
 Griffyth 	M
 Griflet 	M
 Grimbold 	M
 Grimm 	M
 Grimme 	M
 Grindan 	M
 Gringalet 	M
 Gringolet 	M
 Grioghar 	M
 Griorgair 	M
 Grisandole 	F
 Griselda 	F
 Griselde 	F
 Grisella 	F
 Grisham 	M
 Grisjahilde 	F
 Griswald 	M
 Griswalda 	F
 Griswalde 	F
 Griswold 	M
 Grizel 	F
 Grizela 	F
 Grosvenor 	M
 Grover 	M
 Gruddieu 	M
 Gryfflet 	M
 Gryselda 	F
 Guadalupe 	F
 Gualterio 	M
 Gualtiero 	M
 Guanhamara 	F
 Guanhumora 	F
 Gubnat 	F
 Gudrun 	F
 Gudruna 	F
 Guendolen 	F
 Guenevere 	F
 Guenloie 	F
 Guennola 	F
 Guerehes 	M
 Guglielmo 	M
 Guida 	F
 Guiditta 	F
 Guido 	M
 Guifford 	M
 Guilaine 	F
 Guilbert 	M
 Guillaume 	M
 Guillelmina 	F
 Guillermo 	M
 Guinevere 	F
 Guiseppe 	M
 Guiseppie 	F
 Guiseppina 	F
 Guivret 	M
 Gunilla 	F
 Gunn 	M
 Gunna 	F
 Gunnar 	M
 Gunnel 	F
 Gunner 	M
 Gunther 	M
 Gurgalan 	M
 Guri 	M
 Gurice 	F
 Gurion 	M
 Gurit 	F
 Gus 	M
 Guss 	M
 Gussie 	F
 Gust 	M
 Gusta 	F
 Gustaf 	M
 Gustav 	M
 Gustava 	F
 Gustave 	M
 Gustavo 	M
 Gustel 	F
 Guyapi 	M
 Guyon 	M
 Gvenour 	F
 Gwalchmai 	M
 Gwawl 	M
 Gwen 	F
 Gwenddydd 	F
 Gwendolen 	F
 Gwendolin 	F
 Gwendoloena 	F
 Gwendolyn 	F
 Gweneth 	F
 Gwenevere 	F
 Gwenhwyfach 	F
 Gwenith 	F
 Gwenn 	F
 Gwenneth 	F
 Gwenyver 	F
 Gwern 	M
 Gwernaeh 	M
 Gwri 	M
 Gwyndolin 	F
 Gwynham 	M
 Gwynith 	F
 Gwynn 	F
 Gylda 	F
 Gyldan 	F
 Gypsy 	F
 Gytha 	F
 Gzifa 	F
 Habib 	M
 Hacket 	M
 Hackett 	M
 Hadar 	M
 Hadara 	F
 Hadarah 	F
 Hadassah 	F
 Haddad 	M
 Hadden 	M
 Haddon 	M
 Haden 	M
 Hadiya 	F
 Hadley 	F
 Hadon 	M
 Hadrian 	M
 Hadu 	F
 Haduwig 	F
 Hadwin 	M
 Hadwyn 	M
 Hadya 	F
 Haefen 	M
 Haele 	M
 Haesel 	F
 Haestingas 	M
 Haethowine 	M
 Hagaleah 	M
 Hagalean 	M
 Hagan 	M
 Hagar 	F
 Hagaward 	M
 Hagley 	M
 Hagly 	M
 Hagos 	M
 Hahkethomemah 	M
 Hahnee 	M
 Haig 	M
 Hailee 	F
 Hailey 	F
 Hailie 	F
 Haji 	M
 Hakan 	M
 Hakeem 	M
 Hakidonmuya 	F
 Hakim 	M
 Hal 	M
 Halag 	F
 Halah 	F
 Halbart 	M
 Halbert 	M
 Halburt 	M
 Haldane 	M
 Halden 	M
 Hale 	M
 Halebeorht 	M
 Haleigh 	F
 Halette 	F
 Haley 	F
 Halford 	M
 Halfrid 	F
 Halfrida 	F
 Halfrith 	F
 Halfryta 	F
 Hali 	F
 Halia 	F
 Halie 	F
 Halifrid 	F
 Halig 	M
 Haligwiella 	M
 Halim 	M
 Halima 	F
 Hall 	M
 Hallam 	M
 Halle 	F
 Halley 	M
 Hallfrita 	F
 Hallie 	F
 Halliwell 	M
 Hallwell 	M
 Halona 	F
 Halsey 	M
 Halsig 	M
 Halstead 	M
 Halton 	M
 Halwende 	M
 Hamal 	M
 Hamden 	M
 Hamdun 	M
 Hamelstun 	M
 Hamia 	F
 Hamid 	M
 Hamilton 	M
 Hamlet 	M
 Hamlett 	M
 Hamlin 	M
 Hammad 	M
 Hamoelet 	M
 Hamp 	M
 Hampton 	M
 Hamza 	M
 Han 	M
 Hana 	F
 Hanan 	M
 Hananel 	M
 Hanford 	M
 Hania 	M
 Hanif 	M
 Hanisi 	M
 Hank 	M
 Hanley 	M
 Hanlon 	M
 Hanly 	M
 Hann 	M
 Hanna 	F
 Hannah 	F
 Hannalee 	F
 Hanne 	F
 Hannela 	F
 Hannele 	F
 Hanno 	M
 Hanraoi 	M
 Hanrietta 	F
 Hanriette 	F
 Hans 	M
 Hansel 	M
 Hanz 	M
 Harac 	M
 Haraford 	M
 Harailt 	M
 Harald 	M
 Harb 	M
 Harbin 	M
 Harcourt 	M
 Harden 	M
 Hardin 	M
 Harding 	M
 Hardouin 	M
 Hardtman 	M
 Hardwin 	M
 Hardwyn 	M
 Hardy 	M
 Hardyn 	M
 Hare 	M
 Harel 	M
 Harelache 	M
 Hareleah 	M
 Harford 	M
 Hargrove 	M
 Hariman 	M
 Harimann 	M
 Harimanna 	F
 Harimanne 	F
 Harimilla 	F
 Harkahome 	M
 Harlak 	M
 Harlake 	M
 Harlan 	M
 Harland 	M
 Harleen 	F
 Harleigh 	M
 Harlen 	M
 Harley 	M
 Harlie 	F
 Harlon 	M
 Harlow 	M
 Harlowe 	M
 Harman 	M
 Harmen 	M
 Harmon 	M
 Harmonee 	F
 Harmonie 	F
 Harmony 	F
 Harold 	M
 Haroun 	M
 Haroun al Rachid 	M
 Harper 	M
 Harrell 	M
 Harriet 	F
 Harriett 	F
 Harrietta 	F
 Harriette 	F
 Harriman 	M
 Harrington 	M
 Harris 	M
 Harrison 	M
 Harrod 	M
 Harry 	M
 Hart 	M
 Harte 	M
 Hartford 	M
 Harti 	M
 Hartley 	M
 Hartman 	M
 Hartmann 	M
 Hartun 	M
 Hartwell 	M
 Hartwood 	M
 Harun 	M
 Harun al Rachid 	M
 Harve 	M
 Harvey 	M
 Harvy 	M
 Hasana 	F
 Hashim 	M
 Hasina 	F
 Haskell 	M
 Haslet 	M
 Haslett 	M
 Hasna 	F
 Hassan 	M
 Hassie 	F
 Hassun 	M
 Hastiin 	M
 Hastings 	M
 Hattie 	F
 Hausis 	F
 Hausisse 	F
 Havyn 	M
 Hawa 	F
 Hawiovi 	M
 Hawley 	M
 Hawly 	M
 Haya 	F
 Hayden 	M
 Haydon 	M
 Haye 	M
 Hayes 	M
 Hayle 	M
 Haylee 	F
 Hayley 	F
 Haylie 	F
 Hayward 	M
 Haywood 	M
 Hayyim 	M
 Hazel 	F
 Hazell 	F
 Hazle 	F
 He lush ka 	M
 Heahweard 	M
 Healhtun 	M
 Heall 	M
 Healleah 	M
 Heallfrith 	F
 Heallstede 	M
 Healum 	M
 Healy 	M
 Heammawihio 	M
 Heanford 	M
 Heanleah 	M
 Heardind 	M
 Heardwine 	M
 Hearne 	M
 Hearpere 	M
 Heath 	M
 Heathcliff 	M
 Heathclyf 	M
 Heathdene 	M
 Heather 	F
 Heathleah 	M
 Heathley 	M
 Heaven 	F
 Heber 	M
 Hector 	M
 Hedda 	F
 Hedvige 	F
 Hedwig 	F
 Hedy 	F
 Hefeydd 	M
 Hegarty 	M
 Hehewuti 	F
 Heida 	F
 Heide 	F
 Heidi 	F
 Heilyn 	M
 Heinrich 	M
 Hekli 	M
 Helaine 	F
 Helaku 	M
 Helen 	F
 Helena 	F
 Helene 	F
 Helga 	F
 Hellekin 	M
 Hellen 	F
 Helma 	F
 Helmer 	M
 Helmut 	M
 Helmutt 	M
 Heloise 	F
 Helsa 	F
 Helsin 	F
 Helton 	M
 Helyn 	F
 Henbeddestr 	M
 Henderson 	M
 Hendrika 	F
 Henery 	M
 Hengist 	M
 Hennessy 	M
 Henretta 	F
 Henri 	M
 Henrick 	M
 Henrietta 	F
 Henriette 	F
 Henrik 	M
 Henriqua 	F
 Henry 	M
 Henson 	M
 Henwas 	M
 Heolstor 	M
 Heorot 	M
 Heort 	M
 Heortwiella 	M
 Heortwode 	M
 Hephzibah 	F
 Hepsiba 	F
 Hepzibeth 	F
 Herald 	M
 Heraldo 	M
 Herb 	M
 Herbert 	M
 Hererinc 	M
 Heretoga 	M
 Heriberto 	M
 Herlbert 	M
 Herlebeorht 	M
 Herlinda 	F
 Herman 	M
 Hermina 	F
 Hermine 	F
 Herminia 	F
 Hermon 	M
 Hermosa 	F
 Hern 	M
 Hernan 	M
 Hernandez 	M
 Hernando 	M
 Herne 	M
 Herrick 	M
 Herschel 	M
 Hershel 	M
 Herta 	F
 Hertha 	F
 Herve 	M
 Herzeloyde 	F
 Heskovizenako 	M
 Hessie 	F
 Hester 	F
 Hesutu 	M
 Hetheclif 	M
 Hettie 	F
 Hetty 	F
 Hevataneo 	M
 Hevovitastamiutsto 	M
 Hewett 	M
 Hewitt 	M
 Hewlett 	M
 Hewlitt 	M
 Heywood 	M
 Hezekiah 	M
 Hiamovi 	M
 Hiatt 	M
 Hickey 	M
 Hida 	F
 Hieremias 	M
 Hiero 	M
 Higgins 	M
 Hilaire 	F
 Hilario 	M
 Hilary 	F
 Hilbert 	M
 Hild 	F
 Hilda 	F
 Hildagarde 	F
 Hildbrand 	M
 Hilde 	F
 Hildegard 	F
 Hildegarde 	F
 Hildehrand 	M
 Hildemar 	F
 Hildemara 	F
 Hilderinc 	M
 Hildie 	F
 Hildimar 	F
 Hildireth 	F
 Hildred 	F
 Hildreth 	F
 Hildur 	F
 Hillard 	M
 Hillary 	F
 Hilliard 	M
 Hillock 	M
 Hillocke 	M
 Hilma 	F
 Hilton 	M
 Hinto 	M
 Hiolair 	F
 Hiram 	M
 Hiroshi 	M
 Hisolda 	F
 Hlaford 	M
 Hline 	M
 Hlink 	M
 Hlisa 	M
 Hlithtun 	M
 Hlynn 	F
 Hobard 	M
 Hobart 	M
 Hobbard 	M
 Hobert 	M
 Hobson 	M
 Hod 	M
 Hodsone 	M
 Hoel 	M
 Hogan 	M
 Hoh 	M
 Hohberht 	M
 Hohnihohkaiyohos 	M
 Hoireabard 	M
 Hoke 	M
 Hok'ee 	M
 Hola 	F
 Holbrook 	M
 Holcomb 	M
 Holda 	F
 Holde 	F
 Holden 	M
 Holdin 	M
 Holdyn 	M
 Holea 	F
 Holle 	F
 Hollee 	F
 Holli 	F
 Hollie 	F
 Hollis 	M
 Holly 	F
 Holman 	M
 Holmes 	M
 Holt 	M
 Holwell 	M
 Home 	M
 Homer 	M
 Honani 	M
 Honaw 	M
 Honbria 	F
 Honbrie 	F
 Hondo 	M
 Honi 	M
 Honiahaka 	M
 Honon 	M
 Honora 	F
 Honoratas 	F
 Honorato 	M
 Honore 	F
 Honoria 	F
 Honovi 	M
 Hoover 	M
 Horace 	M
 Horado 	M
 Horatio 	M
 Hortencia 	F
 Hortense 	F
 Horton 	M
 Hosanna 	F
 Hosea 	M
 Hosie 	M
 Hosteen 	M
 Hotah 	M
 Hototo 	M
 Hotuaekhaashtait 	M
 Houdain 	M
 Houdenc 	M
 Houerv 	M
 Houghton 	M
 Houston 	M
 Howahkan 	M
 Howard 	M
 Howe 	M
 Howel 	M
 Howell 	M
 Howi 	M
 Howie 	M
 Howland 	M
 Hoyt 	M
 Hraefnscaga 	M
 Hrapenly 	M
 Hring 	M
 Hristun 	M
 Hroc 	M
 Hrocby 	M
 Hrocesburh 	M
 Hrothbeorhta 	F
 Hrothberta 	F
 Hrothbertina 	F
 Hrothgar 	M
 Hrothnerta 	F
 Hrothrehr 	M
 Hrycg 	M
 Hrychleah 	M
 Hrypa 	M
 Hrypanleah 	M
 Hrytherford 	M
 Hsmilton 	M
 Huan Yue 	F
 Huarwar 	M
 Hubbard 	M
 Hubert 	M
 Huberta 	F
 Hud 	M
 Hudson 	M
 Hueil 	M
 Huette 	F
 Huetts 	F
 Huey 	M
 Hugette 	F
 Hugh 	M
 Hughes 	M
 Hughetta 	F
 Hughette 	F
 Hughie 	M
 Hugi 	M
 Hugiet 	F
 Hugiherahta 	F
 Hugo 	M
 Huguetta 	F
 Hulbard 	M
 Hulbart 	M
 Hulbert 	M
 Hulda 	F
 Huldah 	F
 Hulde 	F
 Huldiberaht 	M
 Humayd 	M
 Humberto 	M
 Hume 	M
 Humility 	M
 Humita 	F
 Humphrey 	M
 Hunfrid 	M
 Hunfried 	M
 Hungas 	M
 Hunig 	F
 Huntingden 	M
 Huntingdon 	M
 Huntington 	M
 Huntingtun 	M
 Huntley 	M
 Huntly 	M
 Hurit 	F
 Huritt 	M
 Hurlbart 	M
 Hurlbert 	M
 Hurley 	M
 Hurst 	M
 Hurste 	M
 Husain 	M
 Husam al Din 	M
 Husani 	M
 Husayn 	M
 Hussain 	M
 Hussein 	M
 Huston 	M
 Hutton 	M
 Huxeford 	M
 Huxford 	M
 Huxley 	M
 Huxly 	M
 Hwaeteleah 	M
 Hweolere 	M
 Hwertun 	M
 Hwistlere 	M
 Hwitby 	M
 Hwitcomb 	M
 Hwitcumb 	M
 Hwitford 	M
 Hwithloew 	M
 Hwitloc 	M
 Hyatt 	M
 Hyde 	M
 Hylda 	F
 Hyman 	M
 Hyrum 	M
 Iago 	M
 Iain 	M
 Iakovos 	M
 Iamar 	F
 Ian 	M
 Iaokim 	M
 Ibernia 	F
 Iblis 	F
 Ibrahim 	M
 Ichabod 	M
 Icie 	F
 Icy 	F
 Ida 	F
 Idaia 	F
 Idal 	M
 Idalie 	F
 Ide 	F
 Idelisa 	F
 Idell 	F
 Idella 	F
 Idelle 	F
 Iden 	M
 Idetta 	F
 Idette 	F
 Idi 	M
 Idla 	F
 Idna 	F
 Idoia 	F
 Idrissa 	M
 Idurre 	F
 Ierne 	F
 Iesha 	F
 Ifeoma 	F
 Ifig 	F
 Igasho 	M
 Igerne 	F
 Ignace 	M
 Ignacia 	F
 Ignacio 	M
 Ignado 	M
 Ignatius 	M
 Ignazio 	M
 Igone 	F
 Igraine 	F
 Igrayne 	F
 Ike 	M
 Ikerne 	F
 Ila 	F
 Ilana 	F
 Ilane 	F
 Ilanit 	F
 Ilari 	M
 Ilario 	M
 Ilde 	F
 Ileanna 	F
 Ilena 	F
 Ilene 	F
 Ilia 	F
 Iliana 	F
 Ilias 	M
 Illanipi 	M
 Illias 	M
 Ilona 	F
 Ilsa 	F
 Ilse 	F
 Iluminada 	F
 Ilyse 	F
 Ima 	F
 Imala 	F
 Iman 	F
 Imani 	F
 Imanol 	M
 Imelda 	F
 Immaculada 	F
 Immanuel 	M
 Imogene 	F
 Ina 	F
 Incendio 	M
 Inda 	F
 Indee 	F
 India 	F
 Indiana 	F
 Ine 	M
 Inell 	F
 Inerney 	M
 Ines 	F
 Inez 	F
 Inga 	F
 Ingall 	M
 Ingalls 	M
 Ingeborg 	F
 Ingel 	M
 Ingelbert 	M
 Ingelise 	F
 Inger 	F
 Inghean 	F
 Inghinn 	F
 Inglebert 	M
 Ingrid 	F
 Iniga 	F
 Iniko 	M
 Inis 	M
 Iniss 	M
 Innes 	M
 Inness 	M
 Innis 	M
 Innocent 	M
 Innocenzio 	M
 Inocencio 	M
 Inoceneia 	F
 Inocenta 	F
 Inocente 	M
 Inteus 	M
 Intisar 	F
 Intisara 	F
 Intizara 	F
 Inys 	M
 Ioan 	M
 Iola 	F
 Iolana 	F
 Iona 	F
 Ionanna 	F
 Ione 	F
 Ionnes 	M
 Iosep 	M
 Ioseph 	M
 Iov 	M
 Ipo 	F
 Ira 	M
 Iratze 	F
 Irena 	F
 Irenbend 	M
 Irene 	F
 Iris 	F
 Irl 	M
 Irma 	F
 Irmgard 	F
 Irmigard 	F
 Irmina 	F
 Irmine 	F
 Irmuska 	F
 Irune 	F
 Irven 	M
 Irvetta 	F
 Irvette 	F
 Irvin 	M
 Irvine 	M
 Irving 	M
 Irvyn 	M
 Irwin 	M
 Irwyn 	M
 Isa 	F
 Isaac 	M
 Isaak 	M
 Isaakios 	M
 Isabeau 	F
 Isabel 	F
 Isabela 	F
 Isabell 	F
 Isabella 	F
 Isabelle 	F
 Isadore 	M
 Isadoro 	M
 Isai 	M
 Isaiah 	M
 Isaias 	M
 Isana 	F
 Isane 	F
 Isdemus 	M
 Iseabail 	M
 Iseabal 	F
 Isen 	M
 Isenham 	M
 Isha 	F
 Isham 	M
 Ishmael 	M
 Isi 	F
 Isiah 	M
 Isibeal 	F
 Isidora 	F
 Isidore 	M
 Isidoro 	M
 Isidro 	M
 Isis 	F
 Iskinder 	M
 Isleen 	F
 Islene 	F
 Ismael 	M
 Ismitta 	F
 Isobel 	F
 Isold 	F
 Isolda 	F
 Isolde 	F
 Isole 	F
 Isom 	M
 Isoud 	F
 Isoude 	F
 Israel 	M
 Isreal 	M
 Issa 	M
 Issac 	M
 Istaqa 	M
 Istas 	F
 Istu 	M
 Ita 	F
 Itai 	M
 Ither 	M
 Itsaso 	F
 Ittamar 	M
 Ituha 	F
 Itxaro 	F
 Itzel 	F
 Iuwine 	M
 Iva 	F
 Ivah 	F
 Ivalyn 	F
 Ivan 	M
 Ivana 	F
 Ivane 	F
 Ivanna 	F
 Ivar 	M
 Iven 	M
 Iver 	M
 Iverem 	F
 Ives 	M
 Ivette 	F
 Ivey 	M
 Ivie 	F
 Ivo 	M
 Ivon 	M
 Ivonne 	F
 Ivor 	M
 Ivyanne 	F
 Iwdael 	M
 Ixaka 	M
 Iyana 	F
 Iyangura 	F
 Iyanna 	F
 Iye 	M
 Izaak 	M
 Izabella 	F
 Izaiah 	M
 Izar 	F
 Izarra 	F
 Izarre 	F
 Izazkun 	F
 Izett 	F
 Izetta 	F
 Izora 	F
 Izreal 	M
 Izso 	F
 Izusa 	F
 Jaantje 	F
 Jaap 	M
 Jabari 	M
 Jabbar 	M
 Jabin 	M
 Jabir 	M
 Jacalyn 	F
 Jacan 	M
 Jace 	M
 Jacee 	F
 Jacelyn 	F
 Jacey 	F
 Jaci 	F
 Jacinta 	F
 Jacinthe 	F
 Jacinto 	M
 Jackeline 	F
 Jacki 	F
 Jackie 	F
 Jackleen 	F
 Jacklyn 	F
 Jacklynn 	F
 Jackson 	M
 Jacky 	M
 Jaclyn 	F
 Jacob 	M
 Jacoba 	F
 Jacobe 	M
 Jacobo 	M
 Jacoby 	M
 Jacot 	M
 Jacqualine 	F
 Jacque 	F
 Jacqueleen 	M
 Jacquelin 	F
 Jacqueline 	F
 Jacquelyn 	F
 Jacquelyne 	F
 Jacquelynne 	F
 Jacquenetta 	F
 Jacquenette 	F
 Jacques 	M
 Jacqui 	F
 Jacquline 	F
 Jacy 	M
 Jada 	F
 Jade 	F
 Jadee 	F
 Jaden 	M
 Jader 	M
 Jadira 	F
 Jadon 	M
 Jady 	F
 Jadyn 	F
 Jae 	M
 Jaecar 	M
 Jaeda 	F
 Jaeden 	M
 Jaedon 	M
 Jael 	M
 Jaeleah 	F
 Jaelyn 	F
 Jaena 	F
 Jaenette 	F
 Jafari 	M
 Jaffa 	F
 Jafit 	F
 Jafita 	F
 Jager 	M
 Jagger 	M
 Jago 	M
 Jaha 	F
 Jaheim 	M
 Jahi 	M
 Jahiem 	M
 Jahmal 	M
 Jai 	M
 Jaicee 	F
 Jaida 	F
 Jaide 	M
 Jaiden 	M
 Jaidyn 	F
 Jailene 	F
 Jailyn 	F
 Jaime 	M
 Jaimee 	F
 Jaimelynn 	F
 Jaimi 	F
 Jaimie 	F
 Jaina 	F
 Jaine 	F
 Jaione 	F
 Jair 	M
 Jaira 	M
 Jairo 	M
 Jairus 	M
 Jaja 	M
 Jakayla 	F
 Jake 	M
 Jakeem 	M
 Jakinda 	F
 Jaklyn 	F
 Jakob 	M
 Jakoba 	F
 Jakobah 	F
 Jakobe 	M
 Jakobie 	F
 Jakome 	M
 Jaleel 	M
 Jaleesa 	F
 Jalen 	M
 Jalisa 	F
 Jaliyah 	F
 Jalyn 	F
 Jalynn 	F
 Jamaal 	M
 Jamael 	M
 Jamahl 	M
 Jamal 	M
 Jamall 	M
 Jamar 	M
 Jamarcus 	M
 Jamari 	M
 Jamarion 	M
 Jame 	M
 Jamee 	F
 Jameel 	M
 Jameelah 	F
 Jamel 	M
 Jamelia 	F
 James 	M
 Jameson 	M
 Jamey 	M
 Jami 	F
 Jamia 	F
 Jamian 	M
 Jamie 	F
 Jamiel 	M
 Jamielee 	F
 Jamieson 	M
 Jamil 	M
 Jamila 	F
 Jamilah 	F
 Jamile 	M
 Jamilia 	F
 Jamilla 	F
 Jamille 	F
 Jamilyn 	F
 Jamin 	M
 Jamir 	M
 Jamison 	M
 Jammie 	M
 Jamon 	M
 Jamya 	F
 Jan 	F
 Jana 	F
 Janae 	F
 Janai 	F
 Janais 	F
 Janay 	F
 Janaya 	M
 Janaye 	F
 Jancsi 	M
 Jane 	F
 Janee 	F
 Janeen 	F
 Janel 	F
 Janell 	F
 Janella 	F
 Janelle 	F
 Janene 	M
 Janessa 	F
 Janet 	F
 Janetta 	F
 Janette 	F
 Janey 	F
 Jani 	M
 Janice 	F
 Janicia 	F
 Janie 	F
 Janiece 	F
 Janina 	F
 Janine 	F
 Janis 	F
 Janise 	F
 Janita 	F
 Janiya 	F
 Janiyah 	F
 Janka 	F
 Jankia 	M
 Janko 	M
 Jann 	F
 Janna 	F
 Jannae 	F
 Janne 	F
 Jannes 	M
 Jannet 	F
 Janneth 	M
 Jannie 	F
 Jannina 	F
 Jannis 	F
 Janos 	M
 Jans 	F
 Jansen 	M
 Jansje 	F
 Janson 	M
 Jantis 	M
 Jantje 	M
 Janyd 	M
 Janyl 	M
 Japera 	F
 Japhet 	M
 Japheth 	M
 Jaquan 	M
 Jaquelin 	F
 Jaquelina 	F
 Jaqueline 	F
 Jaquenette 	F
 Jaques 	M
 Jaquetta 	F
 Jarad 	M
 Jarah 	M
 Jaran 	M
 Jared 	M
 Jarel 	M
 Jarell 	M
 Jaren 	M
 Jarin 	M
 Jarlath 	M
 Jarman 	M
 Jarmann 	M
 Jarod 	M
 Jaron 	M
 Jarrad 	M
 Jarrah 	M
 Jarran 	M
 Jarred 	M
 Jarrel 	M
 Jarrell 	M
 Jarren 	M
 Jarret 	M
 Jarrett 	M
 Jarrod 	M
 Jarron 	M
 Jarvis 	M
 Jaryl 	M
 Jaryn 	M
 Jase 	M
 Jasen 	M
 Jaslynn 	F
 Jasmeen 	F
 Jasmin 	F
 Jasmine 	F
 Jasmyn 	F
 Jasmyne 	F
 Jason 	M
 Jasone 	F
 Jaspar 	M
 Jasper 	M
 Jaunita 	F
 Javen 	M
 Javier 	M
 Javiera 	F
 Javiero 	M
 Javion 	M
 Javon 	M
 Javonte 	M
 Jawara 	M
 Jawhar 	M
 Jax 	M
 Jaxine 	F
 Jaxon 	M
 Jaxson 	M
 Jayar 	M
 Jayce 	M
 Jaycee 	F
 Jaycie 	F
 Jayda 	F
 Jayde 	F
 Jaydee 	M
 Jayden 	M
 Jaydon 	M
 Jaydra 	F
 Jaye 	M
 Jayla 	F
 Jaylan 	M
 Jaylen 	M
 Jaylene 	F
 Jaylin 	M
 Jaylon 	M
 Jaylyn 	F
 Jaylynn 	F
 Jayme 	F
 Jaymee 	F
 Jaymes 	M
 Jaymie 	F
 Jaymin 	M
 Jayna 	M
 Jayne 	F
 Jayni 	F
 Jaynie 	M
 Jayron 	M
 Jayronn 	M
 Jayson 	M
 Jayvee 	M
 Jazlyn 	F
 Jazlynn 	F
 Jazmaine 	F
 Jazmin 	F
 Jazmina 	M
 Jazmine 	F
 Jazmyn 	F
 Jazmyne 	F
 Jazzalyn 	M
 Jazzmine 	F
 Jazzmyn 	M
 Jean Baptiste 	M
 Jeana 	F
 Jeanae 	F
 Jeanay 	F
 Jeane 	F
 Jeanee 	F
 Jeanelle 	M
 Jeanetta 	F
 Jeanette 	F
 Jeanice 	F
 Jeanie 	F
 Jeanina 	M
 Jeanine 	F
 Jeanna 	F
 Jeanne 	F
 Jeannell 	F
 Jeannette 	F
 Jeannie 	F
 Jeannine 	F
 Jeannot 	M
 Jed 	M
 Jedadiah 	M
 Jedaiah 	M
 Jedd 	M
 Jedediah 	M
 Jedi 	M
 Jediah 	M
 Jedidiah 	M
 Jeena 	F
 Jeff 	M
 Jefferey 	M
 Jefferson 	M
 Jeffery 	M
 Jefford 	M
 Jeffrey 	M
 Jeffry 	M
 Jehane 	F
 Jehoichin 	M
 Jehu 	M
 Jela 	M
 Jem 	M
 Jemal 	M
 Jemila 	F
 Jemima 	F
 Jemimah 	F
 Jemina 	F
 Jemma 	F
 Jen 	F
 Jena 	F
 Jenae 	F
 Jenai 	F
 Jenalee 	F
 Jenalyn 	F
 Jenalynn 	F
 Jenarae 	M
 Jenavieve 	F
 Jenay 	F
 Jenaya 	F
 Jenda 	M
 Jenee 	F
 Jeneen 	F
 Jenella 	F
 Jenelle 	F
 Jenene 	F
 Jenetta 	F
 Jenette 	F
 Jeneva 	F
 Jenevieve 	F
 Jeni 	F
 Jenice 	F
 Jeniece 	F
 Jenifer 	F
 Jenilynn 	M
 Jenina 	F
 Jenine 	F
 Jenise 	F
 Jenita 	F
 Jenna 	F
 Jennabel 	F
 Jennae 	F
 Jennah 	F
 Jennalee 	F
 Jennalyn 	M
 Jennarae 	F
 Jennasee 	F
 Jennavieve 	F
 Jennay 	F
 Jennelle 	M
 Jennessa 	F
 Jenneva 	F
 Jenni 	F
 Jennie 	F
 Jennifer 	F
 Jennika 	F
 Jennilee 	F
 Jennilyn 	F
 Jennine 	F
 Jennings 	M
 Jennis 	M
 Jenny 	F
 Jennyann 	F
 Jennyfer 	F
 Jenny-lee 	M
 Jennyver 	F
 Jenralyn 	F
 Jens 	M
 Jensina 	F
 Jensine 	F
 Jenyd 	M
 Jeoffroi 	M
 Jeorjia 	F
 Jeovana 	F
 Jeovanna 	F
 Jephtah 	M
 Jerad 	M
 Jerah 	M
 Jerald 	M
 Jeraldine 	F
 Jeraldo 	M
 Jeralyn 	F
 Jeramie 	M
 Jeramy 	M
 Jeran 	M
 Jerande 	M
 Jerard 	M
 Jerardo 	M
 Jere 	M
 Jered 	M
 Jerel 	M
 Jerelyn 	F
 Jereme 	M
 Jeremey 	M
 Jeremi 	M
 Jeremiah 	M
 Jeremias 	M
 Jeremie 	M
 Jeremy 	M
 Jeren 	M
 Jerett 	M
 Jeri 	F
 Jeriah 	M
 Jeric 	M
 Jericho 	M
 Jerick 	M
 Jerico 	M
 Jeriel 	M
 Jerilyn 	F
 Jerilynn 	F
 Jermain 	M
 Jermaine 	M
 Jermane 	M
 Jermayne 	M
 Jermey 	M
 Jerod 	M
 Jerold 	M
 Jerome 	M
 Jeromy 	M
 Jeronimo 	M
 Jerrad 	M
 Jerrah 	M
 Jerrald 	M
 Jerrall 	M
 Jerred 	M
 Jerrel 	M
 Jerrell 	M
 Jerren 	M
 Jerrett 	M
 Jerri 	F
 Jerric 	M
 Jerrica 	F
 Jerrick 	M
 Jerrie 	F
 Jerriel 	M
 Jerrilyn 	F
 Jerrin 	M
 Jerrod 	M
 Jerrold 	M
 Jerron 	M
 Jerry 	M
 Jerryl 	M
 Jerusha 	F
 Jervis 	M
 Jeryl 	M
 Jesiah 	M
 Jesica 	F
 Jesper 	M
 Jess 	M
 Jessamina 	F
 Jessamine 	F
 Jessamyn 	F
 Jesse 	M
 Jessey 	M
 Jessi 	F
 Jessica 	F
 Jessie 	F
 Jessika 	F
 Jessy 	M
 Jesus 	M
 Jesusa 	F
 Jethro 	M
 Jett 	M
 Jettie 	F
 Jevon 	M
 Jewell 	F
 Jia Li 	F
 Jiang Li 	F
 Jiao 	F
 Jibril 	M
 Jifunza 	F
 Jilian 	F
 Jill 	F
 Jillanne 	F
 Jillayne 	F
 Jillene 	F
 Jillesa 	F
 Jillian 	F
 Jilliane 	F
 Jilliann 	M
 Jillianna 	F
 Jillianne 	F
 Jilly 	F
 Jim 	M
 Jimena 	F
 Jimi 	F
 Jimiyu 	M
 Jimmi 	F
 Jimmie 	M
 Jimmy 	M
 Jin 	F
 Jineen 	F
 Jing 	F
 Jinni 	F
 Jinny 	M
 Jiri 	M
 Jiselle 	F
 Joachim 	M
 Joan 	F
 Joana 	F
 Joanie 	F
 Joann 	F
 Joanna 	F
 Joanne 	F
 Joaquin 	M
 Joaquina 	F
 Joaquine 	F
 Job 	M
 Jobe 	M
 Jobina 	F
 Joby 	M
 Jocelin 	F
 Jocelina 	M
 Joceline 	F
 Jocelyn 	F
 Jocelyne 	F
 Jocelynn 	F
 Jochebed 	F
 Jocheved 	M
 Joda 	F
 Jodee 	F
 Jodi 	F
 Jodie 	F
 Jody 	F
 Joe 	M
 Joeanna 	F
 Joeanne 	F
 Joed 	M
 Joel 	M
 Joeliyn 	F
 Joell 	F
 Joella 	F
 Joelle 	F
 Joellen 	F
 Joelliana 	F
 Joelliane 	F
 Joen 	M
 Joeseph 	M
 Joesph 	M
 Joey 	M
 Johan 	M
 Johana 	F
 Johann 	M
 Johanna 	F
 Johannah 	F
 Johannes 	M
 Johathan 	M
 Johfrit 	M
 John 	M
 Johnathan 	M
 Johnathon 	M
 Johnelle 	F
 Johnetta 	F
 Johnette 	F
 Johnie 	M
 Johnn 	M
 Johnna 	F
 Johnnie 	M
 Johnny 	M
 Johnpaul 	M
 John-paul 	M
 Johnson 	M
 Johnston 	M
 Johny 	M
 Johyna 	F
 Joi 	F
 Joia 	F
 Joie 	F
 Joka 	F
 Jokin 	M
 Jokina 	F
 Jokine 	F
 Jola 	F
 Jolan 	F
 Jolanka 	F
 Jolee 	F
 Joleen 	F
 Joleigh 	F
 Jolena 	F
 Jolene 	F
 Joli 	F
 Jolie 	F
 Jolina 	F
 Joline 	F
 Jolleen 	F
 Jollene 	F
 Jolon 	M
 Jomar 	M
 Jomo 	M
 Jon 	M
 Jonah 	M
 Jonalyn 	F
 Jonalynn 	F
 Jonam 	M
 Jonas 	M
 Jonatan 	M
 Jonathan 	M
 Jonathon 	M
 Jonati 	F
 Jonay 	F
 Jone 	F
 Jonell 	F
 Jones 	M
 Jonetta 	F
 Jonette 	F
 Joni 	F
 Jonita 	F
 Jonn 	M
 Jonna 	F
 Jonnelle 	F
 Jonni 	M
 Jonnie 	F
 Joop 	M
 Joosef 	M
 Jooseppi 	M
 Jopie 	M
 Jorah 	M
 Joram 	M
 Joran 	M
 Jorcina 	F
 Jordain 	M
 Jordan 	M
 Jordana 	F
 Jordane 	F
 Jordanna 	M
 Jordanne 	F
 Jordell 	M
 Jorden 	M
 Jordi 	M
 Jordon 	M
 Jordy 	M
 Jordyn 	F
 Jore 	M
 Jorel 	M
 Jorell 	M
 Joren 	M
 Joretta 	F
 Jorge 	M
 Jorgelina 	F
 Jorgen 	M
 Jori 	M
 Jorian 	M
 Jorie 	M
 Jorim 	M
 Joris 	M
 Jorja 	F
 Jorrel 	M
 Jorrell 	M
 Jory 	M
 Josalind 	F
 Josalyn 	F
 Josalynn 	F
 Josceline 	F
 Joscelyn 	F
 Joscelyne 	F
 Jose 	M
 Joseba 	M
 Josebe 	F
 Josee 	F
 Josef 	M
 Josefa 	F
 Josefina 	F
 Joselito 	M
 Joselyn 	F
 Joseph 	M
 Josepha 	F
 Josephe 	F
 Josephina 	F
 Josephine 	F
 Josephus 	M
 Josetta 	F
 Josette 	F
 Josh 	M
 Joshua 	M
 Josiah 	M
 Josias 	M
 Josie 	F
 Josiephine 	F
 Josilyn 	M
 Josina 	F
 Joslin 	F
 Joslyn 	F
 Joss 	M
 Jossie 	F
 Josu 	M
 Josue 	M
 Josune 	F
 Jotham 	M
 Jourdaine 	M
 Jourdan 	M
 Jourdon 	M
 Jov 	M
 Jovan 	M
 Jovana 	F
 Jovani 	M
 Jovanna 	F
 Jovanni 	M
 Jovanny 	M
 Jovany 	M
 Jovena 	F
 Jovina 	F
 Jovita 	F
 Joxepa 	F
 Joya 	F
 Joyann 	F
 Joyanna 	M
 Joyanne 	F
 Joyce 	F
 Joyceanne 	F
 Joycelyn 	F
 Joycelynn 	F
 Joye 	F
 Joyelle 	F
 Joziah 	M
 Jozlyn 	F
 Jozsa 	F
 Juan 	M
 Juana 	F
 Juanetta 	F
 Juanisha 	F
 Juanita 	F
 Juanito 	M
 Juba 	F
 Jubal 	M
 Juci 	F
 Jucika 	F
 Jud 	M
 Judah 	M
 Judas 	M
 Judd 	M
 Jude 	M
 Judeana 	F
 Judeena 	F
 Judi 	F
 Judie 	F
 Judit 	F
 Judith 	F
 Juditha 	F
 Judson 	M
 Judy 	F
 Juha 	M
 Jukka 	M
 Jule 	M
 Julee 	F
 Juleen 	F
 Jules 	M
 Juli 	F
 Julia 	F
 Julian 	M
 Juliana 	F
 Juliann 	F
 Julianna 	F
 Julianne 	F
 Juliano 	M
 Julie 	F
 Julien 	M
 Julienne 	F
 Juliet 	F
 Julieta 	F
 Julietta 	F
 Juliette 	F
 Julina 	F
 Julio 	M
 Julious 	M
 Julissa 	F
 Julita 	F
 Julius 	M
 Jullien 	M
 Juma 	M
 Jumanah 	F
 Junie 	F
 Junien 	M
 Junious 	M
 Junius 	M
 Jurgen 	M
 Jurre 	M
 Jussi 	M
 Justain 	M
 Justeen 	F
 Justeene 	F
 Justen 	M
 Justene 	F
 Justice 	M
 Justin 	M
 Justina 	F
 Justine 	F
 Justino 	M
 Justis 	M
 Juston 	M
 Justus 	M
 Justyn 	M
 Justyne 	F
 Jutka 	F
 Juwan 	M
 Jwahir 	F
 Jyl 	F
 Jyll 	M
 Jyllina 	F
 K.c. 	F
 Kaaria 	M
 Kaarle 	M
 Kaarlo 	M
 Kabaka 	M
 Kacee 	F
 Kacey 	F
 Kachada 	M
 Kachina 	F
 Kaci 	F
 Kacia 	F
 Kacie 	F
 Kacy 	F
 Kadar 	M
 Kade 	M
 Kadee 	F
 Kadeem 	M
 Kaden 	M
 Kadence 	F
 Kadi 	F
 Kadia 	F
 Kadian 	F
 Kadie 	F
 Kadienne 	F
 Kadija 	F
 Kadin 	M
 Kadir 	M
 Kady 	F
 Kaedee 	M
 Kaela 	F
 Kaelah 	F
 Kaelee 	F
 Kaeleigh 	F
 Kaelene 	F
 Kaeley 	F
 Kaeli 	F
 Kaelie 	F
 Kaelin 	F
 Kaelyn 	F
 Kaelynn 	F
 Kaesha 	F
 Kaga 	M
 Kagan 	M
 Kagen 	M
 Kaherdin 	M
 Kahleil 	M
 Kahli 	F
 Kahlil 	M
 Kai 	M
 Kaia 	F
 Kaiden 	M
 Kaila 	F
 Kailan 	F
 Kailani 	F
 Kailee 	F
 Kailene 	M
 Kailey 	F
 Kaili 	M
 Kailin 	F
 Kailyn 	F
 Kailynne 	F
 Kaimi 	M
 Kaiser 	M
 Kaitlan 	F
 Kaitleen 	F
 Kaitlin 	F
 Kaitlyn 	F
 Kaitlynn 	F
 Kaiya 	F
 Kajika 	M
 Kakawangwa 	F
 Kala 	F
 Kalama 	F
 Kalan 	F
 Kalani 	M
 Kalanie 	F
 Kalanit 	F
 Kale 	M
 Kalea 	F
 Kaleb 	M
 Kalee 	F
 Kalei 	F
 Kaleigh 	F
 Kalen 	M
 Kalena 	F
 Kaley 	F
 Kali 	F
 Kalie 	F
 Kalil 	M
 Kalila 	F
 Kalilah 	F
 Kalin 	F
 Kaliq 	M
 Kaliyah 	F
 Kalle 	M
 Kalli 	F
 Kallie 	F
 Kallita 	M
 Kally 	F
 Kalman 	M
 Kaloni 	F
 Kalyn 	F
 Kalynn 	F
 Kam 	M
 Kamal 	M
 Kamaria 	F
 Kamau 	M
 Kambiri 	F
 Kambria 	F
 Kamden 	M
 Kamea 	F
 Kamelia 	F
 Kameo 	F
 Kameron 	M
 Kami 	F
 Kamil 	M
 Kamila 	F
 Kamilah 	F
 Kamilla 	F
 Kamille 	F
 Kamlyn 	F
 Kammi 	F
 Kammie 	F
 Kamren 	F
 Kamrin 	F
 Kamron 	M
 Kamryn 	F
 Kana 	M
 Kandace 	F
 Kandee 	F
 Kandi 	F
 Kandice 	F
 Kandis 	F
 Kandiss 	M
 Kandy 	F
 Kandyce 	F
 Kane 	M
 Kanelinqes 	M
 Kangee 	M
 Kanika 	F
 Kannelite 	F
 Kanoa 	M
 Kanti 	F
 Kanye 	M
 Kapono 	M
 Kapri 	F
 Kaprice 	F
 Kapricia 	F
 Kaprisha 	F
 Kara 	F
 Karan 	F
 Karcsi 	M
 Kardeiz 	M
 Kareef 	M
 Kareem 	M
 Karel 	M
 Karen 	F
 Kari 	F
 Karida 	F
 Karie 	F
 Karif 	M
 Karim 	M
 Karima 	F
 Karimah 	F
 Karin 	F
 Karina 	F
 Karisma 	F
 Karissa 	F
 Karl 	M
 Karla 	F
 Karlee 	F
 Karleen 	F
 Karleigh 	F
 Karlen 	F
 Karlene 	F
 Karlens 	M
 Karlesha 	F
 Karley 	F
 Karli 	F
 Karlie 	F
 Karlin 	F
 Karlina 	F
 Karline 	F
 Karlis 	M
 Karlitis 	M
 Karlotta 	F
 Karly 	F
 Karlyn 	M
 Karmel 	M
 Karmelit 	F
 Karmelita 	F
 Karmen 	F
 Karmia 	F
 Karmina 	F
 Karmit 	F
 Karney 	M
 Karol 	F
 Karola 	F
 Karolina 	F
 Karoline 	F
 Karoly 	M
 Karolyn 	F
 Karon 	F
 Karren 	F
 Karri 	F
 Karrie 	F
 Karrin 	F
 Karson 	M
 Karyn 	F
 Kasa 	F
 Kasandra 	F
 Kaseeb 	M
 Kaseem 	M
 Kasey 	F
 Kashka 	M
 Kasia 	M
 Kasib 	M
 Kasie 	F
 Kasim 	M
 Kassa 	M
 Kassandra 	F
 Kassi 	M
 Kassia 	F
 Kassidy 	F
 Kassie 	F
 Kassim 	M
 Kat 	F
 Katarina 	F
 Katchen 	F
 Kate 	F
 Kateb 	M
 Katelin 	F
 Kateline 	F
 Katelinn 	M
 Katelyn 	F
 Katelynn 	F
 Katerina 	F
 Kathaleen 	F
 Katharina 	F
 Katharine 	F
 Kathe 	F
 Katherina 	F
 Katherine 	F
 Katheryn 	F
 Kathi 	F
 Kathie 	F
 Kathleen 	F
 Kathleena 	F
 Kathlene 	F
 Kathlyn 	F
 Kathlynn 	M
 Kathrine 	F
 Kathryn 	F
 Kathryne 	F
 Kathrynn 	F
 Kathy 	F
 Kati 	F
 Katia 	M
 Katie 	F
 Katilyn 	F
 Katina 	F
 Katlin 	F
 Katlyn 	F
 Katlynn 	F
 Katlynne 	M
 Kato 	M
 Katriane 	F
 Katriel 	F
 Katrina 	F
 Katrine 	F
 Kattie 	F
 Katura 	M
 Katy 	F
 Kavan 	M
 Kaven 	M
 Kay 	F
 Kaya 	F
 Kayana 	F
 Kayanna 	F
 Kayce 	F
 Kaycee 	F
 Kayci 	F
 Kaycie 	M
 Kayden 	M
 Kaydence 	F
 Kaye 	F
 Kayin 	M
 Kayiyn 	F
 Kayla 	F
 Kaylah 	F
 Kaylan 	M
 Kaylea 	F
 Kaylee 	F
 Kayleen 	F
 Kaylei 	F
 Kayleigh 	F
 Kaylen 	F
 Kaylene 	M
 Kayley 	F
 Kayli 	F
 Kaylie 	F
 Kaylin 	F
 Kaylyn 	F
 Kaylynn 	F
 Kayne 	M
 Keagan 	M
 Keaghan 	M
 Keahi 	M
 Keala 	F
 Kealan 	M
 Keallach 	M
 Kealy 	M
 Kean 	M
 Keana 	F
 Keanan 	M
 Keandre 	M
 Keane 	M
 Keanna 	F
 Keannen 	M
 Keanu 	M
 Keara 	F
 Kearn 	M
 Kearne 	M
 Kearney 	M
 Keary 	M
 Keaton 	M
 Keavy 	F
 Kecia 	F
 Kedar 	M
 Keddrick 	M
 Kedric 	M
 Kedrick 	M
 Keefe 	M
 Keefer 	M
 Keegan 	M
 Keegsquaw 	F
 Keeley 	F
 Keelia 	F
 Keelin 	F
 Keely 	F
 Keelyn 	F
 Keenan 	M
 Keenat 	F
 Keene 	M
 Keenon 	M
 Keesha 	F
 Keezheekoni 	F
 Kefira 	F
 Kegan 	M
 Kei 	M
 Keiana 	F
 Keifer 	M
 Keiki 	F
 Keilah 	M
 Keilani 	F
 Keir 	M
 Keira 	F
 Keiran 	M
 Keisha 	F
 Keita 	M
 Keith 	M
 KeIyn 	F
 Kekipi 	M
 Kekona 	F
 Kelan 	M
 Kelby 	M
 Kelcey 	F
 Kelcie 	F
 Kelcy 	F
 Kele 	M
 Kelilah 	F
 Kelile 	M
 Kellach 	M
 Kelleher 	M
 Kellen 	M
 Kelley 	F
 Kelli 	F
 Kellie 	F
 Kellsey 	F
 Kellsie 	F
 Kelly 	F
 Kelsa 	F
 Kelsea 	F
 Kelsee 	F
 Kelsey 	F
 Kelsi 	F
 Kelsie 	F
 Kelssie 	F
 Kelsy 	F
 Kelton 	M
 Kelula 	F
 Kelvan 	M
 Kelven 	M
 Kelvin 	M
 Kelvyn 	M
 Kelwin 	M
 Kelwyn 	M
 Kelyn 	F
 Keme 	M
 Kemen 	M
 Kemena 	F
 Kemina 	F
 Kemp 	M
 Kempe 	M
 Ken 	M
 Kenan 	M
 Kendal 	F
 Kendale 	M
 Kendall 	M
 Kendel 	M
 Kendell 	M
 Kendhal 	M
 Kendra 	F
 Kendrew 	M
 Kendria 	F
 Kendric 	M
 Kendrick 	M
 Kendriek 	M
 Kendrik 	M
 Kendrix 	M
 Kendryek 	M
 Kendryk 	M
 Kendyl 	F
 Kenelm 	M
 Kengi 	F
 Kenia 	F
 Kenisha 	F
 Kenley 	M
 Kenly 	M
 Kenn 	M
 Kenna 	F
 Kennan 	M
 Kennard 	M
 Kennedi 	F
 Kennedy 	F
 Kennelly 	M
 Kenneth 	M
 Kenney 	M
 Kennith 	M
 Kennocha 	F
 Kennon 	M
 Kennth 	M
 Kenny 	M
 Kenric 	M
 Kenrick 	M
 Kenriek 	M
 Kenrik 	M
 Kenryk 	M
 Kent 	M
 Kentigem 	M
 Kenton 	M
 Kentrell 	M
 Kenward 	M
 Kenway 	M
 Kenya 	F
 Kenyatta 	M
 Kenyon 	M
 Kenzie 	F
 Kenzy 	F
 Keoki 	M
 Keon 	M
 Keona 	F
 Keoni 	M
 Kera 	F
 Keran 	F
 Keren 	F
 Keri 	F
 Keriana 	F
 Keriann 	F
 Kerianna 	F
 Kerianne 	F
 Kerilyn 	F
 Kerk 	M
 Kerman 	M
 Kermeilde 	F
 Kermichil 	M
 Kermilda 	F
 Kermilla 	F
 Kermillie 	F
 Kermit 	M
 Kermode 	M
 Kerr 	M
 Kerra 	F
 Kerri 	F
 Kerrianne 	F
 Kerrick 	M
 Kerrie 	F
 Kerrigan 	M
 Kerrin 	F
 Kerry 	F
 Kerwin 	M
 Kerwyn 	M
 Kesara 	F
 Kesare 	F
 Kesegowaase 	M
 Kesha 	F
 Keshawn 	M
 Keshia 	F
 Kesi 	F
 Kessie 	F
 Kestejoo 	M
 Kester 	M
 Ketifa 	F
 Ketty 	F
 Ketura 	F
 Keturah 	F
 Keva 	F
 Kevan 	M
 Kevay 	F
 Keven 	M
 Keveon 	M
 Kevia 	F
 Kevin 	M
 Kevina 	F
 Kevinn 	M
 Kevion 	M
 Kevis 	M
 Kevon 	M
 Kevron 	M
 Kevyn 	M
 Keyla 	F
 Keyon 	M
 Keyshawn 	M
 Kezia 	F
 Keziah 	F
 Khadijah 	F
 Khaldun 	M
 Khalid 	M
 Khalidah 	F
 Khalil 	M
 Khamisi 	M
 Khanh 	M
 Kharim 	M
 Kharouf 	M
 Khatiti 	F
 Khayri 	M
 Khayyat 	M
 Khoury 	M
 Khristina 	F
 Khrystalline 	F
 Kia 	F
 Kiahna 	F
 Kian 	M
 Kiana 	F
 Kiandra 	F
 Kiandria 	F
 Kiani 	F
 Kianna 	F
 Kianni 	M
 Kiara 	F
 Kiauna 	F
 Kiba 	F
 Kibibi 	F
 Kiefer 	M
 Kiel 	M
 Kiele 	F
 Kienan 	M
 Kiera 	F
 Kieran 	M
 Kiernan 	M
 Kieron 	M
 Kierra 	F
 Kiersten 	F
 Kieth 	M
 Kifle 	M
 Kikka 	F
 Kildaire 	M
 Kildare 	M
 Kile 	M
 Kiley 	F
 Kilian 	M
 Killdaire 	M
 Killian 	M
 Kim 	F
 Kimane 	M
 Kimathi 	M
 Kimball 	M
 Kimber 	F
 Kimberlee 	F
 Kimberley 	F
 Kimberli 	F
 Kimberly 	F
 Kimbra 	F
 Kimbro 	F
 Kimbrough 	F
 Kimi 	F
 Kin 	M
 Kindra 	F
 Kineks 	F
 Kingdon 	M
 Kingsley 	M
 Kingston 	M
 Kingswell 	M
 Kinnat 	F
 Kinneret 	F
 Kinnette 	F
 Kinney 	M
 Kinnon 	M
 Kinny 	M
 Kinsella 	M
 Kinsey 	F
 Kinsley 	M
 Kiona 	F
 Kionah 	F
 Kioni 	F
 Kionna 	F
 Kip 	M
 Kipp 	M
 Kippar 	M
 Kippie 	M
 Kira 	F
 Kirby 	M
 Kirk 	M
 Kirkland 	M
 Kirkley 	M
 Kirklin 	M
 Kirkly 	M
 Kirklyn 	M
 Kirkwood 	M
 Kirsten 	F
 Kirstie 	F
 Kirstin 	F
 Kirt 	M
 Kirwin 	M
 Kirwyn 	M
 Kisha 	F
 Kissa 	F
 Kitchi 	M
 Kitlyn 	F
 Kito 	M
 Kittie 	F
 Kiva 	F
 Kivi 	F
 Kiwidinok 	F
 Kiyoshi 	M
 Kizzie 	F
 Kizzy 	F
 Klaus 	M
 Kleef 	M
 Knocks 	M
 Knoton 	M
 Knox 	M
 Kobe 	M
 Koby 	M
 Kody 	M
 Koen 	M
 Koenraad 	M
 Kofi 	M
 Kohana 	M
 Kohkahycumest 	M
 Koi 	M
 Kojo 	M
 Koko 	F
 Kokyangwuti 	F
 Kolby 	M
 Kole 	M
 Kolena 	F
 Kolichiyaw 	M
 Kolinka 	F
 Kolinkar 	M
 Kolt 	M
 Kolten 	M
 Koltin 	M
 Kolton 	M
 Kona 	F
 Konane 	M
 Kong 	M
 Konni 	M
 Konrad 	M
 Koofrey 	M
 Korbin 	M
 Kord 	M
 Kordale 	M
 Kordell 	M
 Korey 	M
 Kori 	F
 Korrigan 	M
 Kort 	M
 Kortney 	F
 Kory 	M
 Kosumi 	M
 Kotori 	M
 Kourtney 	F
 Kraig 	M
 Kris 	M
 Krisoijn 	M
 Krista 	F
 Kristabelle 	F
 Kristal 	F
 Kristalena 	F
 Kristalyn 	F
 Kristan 	F
 Kristeena 	F
 Kristen 	F
 Kristena 	F
 Kristi 	F
 Kristian 	M
 Kristiana 	F
 Kristiane 	F
 Kristianna 	F
 Kristianne 	F
 Kristie 	F
 Kristin 	F
 Kristina 	F
 Kristine 	F
 Kristofer 	M
 Kristoffer 	M
 Kristopher 	M
 Kristy 	F
 Kristyn 	F
 Kristyne 	F
 Krysta 	F
 Krystabelle 	F
 Krystal 	F
 Krystalyn 	F
 Krystalynn 	F
 Krysten 	F
 Krystiana 	F
 Krystianna 	F
 Krystina 	F
 Krystine 	F
 Krystle 	F
 Krystyna 	F
 Ksena 	F
 Kuan-Yin 	M
 Kuckunniwi 	M
 Kuhlbert 	M
 Kulbart 	M
 Kulbert 	M
 Kumi 	M
 Kuno 	M
 Kunsgnos 	M
 Kunz 	M
 Kuonrada 	F
 Kurt 	M
 Kurtis 	M
 Kuruk 	M
 Kuwanlelenta 	F
 Kuwanyamtiwa 	F
 Kuwanyauma 	F
 Kwabena 	M
 Kwahu 	M
 Kwaku 	M
 Kwame 	M
 Kwami 	M
 Kwatoko 	M
 Kwesi 	M
 Kya 	F
 Kye 	M
 Kyla 	F
 Kylan 	M
 Kylar 	M
 Kyle 	M
 Kylee 	F
 Kyleigh 	F
 Kylen 	M
 Kyler 	M
 Kylie 	F
 Kyndall 	F
 Kyne 	M
 Kynthelig 	M
 Kyra 	F
 Kyran 	M
 Kyree 	M
 Kyrell 	M
 Kyrk 	M
 Kyrksen 	M
 Kyrkwode 	M
 La Reina 	F
 La Row 	F
 La Vergne 	F
 La Verne 	F
 Laban 	M
 Labhaoise 	F
 Lacee 	F
 Lacene 	F
 Lacey 	F
 Lach 	M
 Lache 	M
 Lachlan 	M
 Laci 	F
 Laciann 	F
 Lacie 	F
 Lacina 	F
 Lacy 	F
 Lacyann 	F
 Ladarius 	M
 Ladbroc 	M
 Ladd 	M
 Ladde 	M
 Ladonna 	F
 Laec 	M
 Laefertun 	M
 Lael 	F
 Laetitia 	F
 Lafayette 	M
 Lafe 	M
 Laibrook 	M
 Laidley 	M
 Laidly 	M
 Laila 	F
 Laili 	F
 Lailie 	F
 Lailoken 	M
 Laina 	F
 Laine 	M
 Lainie 	F
 Laird 	M
 Laire 	F
 Lairgnen 	M
 Laisha 	F
 Lakeisha 	F
 Lakeland 	M
 Laken 	F
 Lakesha 	F
 Lakeshia 	F
 Lakiesha 	F
 Lakisha 	F
 Lala 	F
 Lali 	F
 Lalia 	F
 Lalla 	M
 Lalor 	M
 Lamar 	M
 Lamarr 	M
 Lambart 	M
 Lambert 	M
 Lambrecht 	M
 Lambret 	M
 Lambrett 	M
 Lamond 	M
 Lamont 	M
 Lamorak 	M
 Lamorat 	M
 Lana 	F
 Lancdon 	M
 Lance 	M
 Lancelin 	M
 Lancelot 	M
 Landa 	F
 Landen 	M
 Lander 	M
 Landers 	M
 Landis 	M
 Landmari 	M
 Landon 	M
 Landra 	F
 Landrada 	F
 Landry 	M
 Lanette 	F
 Laney 	F
 Lang 	M
 Langdon 	M
 Lange 	M
 Langford 	M
 Langleah 	M
 Langley 	M
 L'Angley 	M
 Langston 	M
 Langundo 	M
 Lani 	F
 Lanice 	F
 Lanie 	F
 Lanna 	F
 Lannie 	M
 Lanny 	M
 Lansa 	M
 Lanston 	M
 Lany 	M
 Laochailan 	M
 Laoghaire 	M
 Laoidhigh 	M
 Lapidos 	M
 Lapidoth 	M
 Lapu 	M
 Laquisha 	F
 Laquita 	F
 Lar 	M
 Lara 	F
 Laraine 	F
 Laramie 	M
 Larcwide 	M
 Lareina 	F
 Laren 	M
 Larena 	F
 Larenzo 	M
 Laria 	F
 Larina 	F
 Larissa 	F
 Larke 	F
 Larkin 	M
 Larnell 	M
 Laron 	M
 Larraine 	F
 Larry 	M
 Lars 	M
 Larue 	F
 Larunda 	F
 Lasalle 	M
 Lashanda 	F
 Lashawn 	F
 Lashonda 	F
 Latanya 	F
 Latarsha 	F
 Latasha 	F
 Lateisha 	F
 Latesha 	F
 Lathrop 	M
 Laticia 	F
 Latimer 	M
 Latisha 	F
 Latonia 	F
 Latonya 	F
 Latosha 	F
 Latoya 	F
 Latrell 	M
 Latrice 	F
 Latricia 	F
 Laudegrance 	M
 Laudine 	F
 Laughlin 	M
 Launcelot 	M
 Launfal 	M
 Laura 	F
 Lauraine 	M
 Laural 	F
 Lauralee 	F
 Lauralyn 	F
 Laurana 	F
 Laureano 	M
 Laureen 	F
 Laurel 	F
 Laurelle 	F
 Lauren 	F
 Laurena 	F
 Laurence 	M
 Laurencia 	F
 Laurene 	F
 Laurenne 	F
 Laurent 	M
 Laurentia 	F
 Laurenz 	M
 Lauretta 	F
 Laurette 	F
 Lauri 	F
 Laurian 	M
 Lauriano 	M
 Laurie 	F
 Lauriel 	F
 Laurinda 	F
 Laurine 	F
 Laurita 	F
 Lauryn 	F
 Lausanne 	F
 Lavada 	F
 Lavan 	M
 Lavar 	M
 Lavena 	F
 Lavenia 	F
 Lavera 	F
 Lavern 	M
 Laverna 	F
 Laverne 	F
 Lavernia 	F
 Lavina 	F
 Lavinia 	F
 Lavon 	F
 Lavonne 	F
 Lawanda 	F
 Lawe 	M
 Lawerence 	M
 Lawford 	M
 Lawley 	M
 Lawly 	M
 Lawrence 	M
 Lawson 	M
 Lawton 	M
 Laycie 	F
 Layla 	F
 Laylie 	F
 Layne 	M
 Layton 	M
 Lazar 	M
 Lazaro 	M
 Lazarus 	M
 Lazzaro 	M
 Lea 	F
 Leachlainn 	M
 Leah 	F
 Leal 	M
 Leala 	F
 Lealia 	F
 Leamon 	M
 Leana 	F
 Leander 	M
 Leandra 	F
 Leandre 	M
 Leandro 	M
 Leane 	M
 Leanian 	M
 Leann 	F
 Leanna 	F
 Leanne 	F
 Lear 	M
 Leary 	M
 Leatha 	F
 Leathan 	M
 Leathlobhair 	M
 Leatrice 	F
 Leax 	M
 Leb 	M
 Lebna 	M
 Lecia 	F
 Leda 	F
 Lee 	M
 Leeann 	F
 Leeanne 	F
 Leeland 	M
 Leena 	F
 Leeroy 	M
 Leesa 	F
 Legarre 	F
 Legget 	M
 Leia 	F
 Leianna 	F
 Leicester 	M
 Leif 	M
 Leigb 	F
 Leigh 	F
 Leighton 	M
 Leila 	F
 Leilah 	F
 Leilani 	F
 Leira 	F
 Leisa 	F
 Leith 	M
 Lela 	F
 Lelah 	F
 Leland 	M
 Lelar 	F
 Lele 	M
 Lelia 	F
 Lella 	F
 Lem 	M
 Lema 	M
 Leman 	M
 Lemuel 	M
 Lemuela 	F
 Len 	M
 Lena 	F
 Lenard 	M
 Lendall 	M
 Lendell 	M
 Leng 	M
 Lenmana 	F
 Lenn 	M
 Lenna 	F
 Lennard 	M
 Lennell 	M
 Lennie 	F
 Lenno 	M
 Lennon 	M
 Lennox 	M
 Lenny 	M
 Lenora 	F
 Lenord 	M
 Lenore 	F
 Leo 	M
 Leocadie 	M
 Leod 	M
 Leoda 	F
 Leodegan 	M
 Leodegrance 	M
 Leodegraunce 	M
 Leof 	M
 Leola 	F
 Leoma 	F
 Leon 	M
 Leona 	F
 Leonard 	M
 Leonarda 	F
 Leonardo 	M
 Leonce 	M
 Leonda 	F
 Leondra 	F
 Leondrea 	F
 Leone 	F
 Leonel 	M
 Leonela 	F
 Leonelle 	F
 Leonia 	F
 Leonides 	M
 Leonie 	F
 Leonor 	F
 Leonora 	F
 Leonore 	F
 Leontina 	F
 Leontine 	F
 Leontyne 	F
 Leopold 	M
 Leopolda 	F
 Leopoldina 	F
 Leopoldine 	F
 Leopoldo 	M
 Leora 	F
 Leota 	F
 Leotie 	F
 Lera 	F
 Leroi 	M
 Leron 	M
 Leroux 	M
 Leroy 	M
 Les 	M
 Lesa 	F
 Lesham 	F
 Lesia 	F
 Leslee 	F
 Lesley 	F
 Lesli 	F
 Leslie 	F
 Lesly 	F
 Lessie 	F
 Lester 	M
 Leta 	F
 Letha 	F
 Leticia 	F
 Letitia 	F
 Letizia 	F
 Letje 	F
 Letta 	F
 Lettie 	F
 Letya 	F
 Lev 	M
 Leva 	F
 Levane 	F
 Levar 	M
 Levene 	F
 Leveret 	M
 Leverett 	M
 Leverton 	M
 Levey 	M
 Levi 	M
 Levia 	F
 Levina 	F
 Levon 	M
 Levy 	M
 Levyna 	F
 Lew 	M
 Lewanna 	F
 Lewi 	M
 Lewis 	M
 Lewy 	M
 Lex 	M
 Lexandra 	F
 Lexann 	M
 Lexi 	F
 Lexie 	F
 Lexus 	F
 Ley 	F
 Leya 	F
 Leyla 	F
 Leyman 	M
 Leyti 	M
 Leza 	F
 Lezlie 	F
 Lia 	F
 Liam 	M
 Lian 	M
 Liana 	F
 Liane 	F
 Liang 	M
 Lianna 	F
 Libbie 	F
 Libby 	F
 Liberty 	F
 Licia 	F
 Lida 	F
 Liddie 	F
 Lidmann 	M
 Lidoine 	F
 Liealia 	F
 Lien 	F
 Liesbet 	F
 Liesheth 	F
 Liesl 	F
 Liezel 	F
 Lifton 	M
 Lige 	M
 Liko 	M
 Lil 	F
 Lila 	F
 Lilah 	F
 Lili 	F
 Lilia 	F
 Lilian 	F
 Liliana 	F
 Liliane 	F
 Lilibet 	F
 Lilibeth 	F
 Lilie 	F
 Lilith 	F
 Lilla 	F
 Lilli 	F
 Lillian 	F
 Lilliana 	F
 Lillie 	F
 Lilly 	F
 Lilo 	F
 Lilyan 	F
 Lilybell 	F
 Lilybeth 	M
 Lin 	M
 Lin Yao 	F
 Lina 	F
 Lincoln 	M
 Lind 	M
 Linda 	F
 Lindael 	M
 Lindberg 	M
 Linddun 	M
 Lindeberg 	M
 Lindel 	M
 Lindell 	M
 Linden 	F
 Lindi 	F
 Lindie 	F
 Lindisfarne 	M
 Lindiwe 	F
 Lindleigh 	M
 Lindley 	M
 Lindly 	M
 Lindsay 	F
 Lindsey 	F
 Lindy 	F
 Line 	M
 Linette 	F
 Linford 	M
 Ling 	F
 Link 	M
 Linleah 	M
 Linley 	M
 Linly 	M
 Linn 	M
 Linne 	F
 Linnea 	F
 Linnette 	F
 Linnie 	F
 Linsey 	F
 Linton 	M
 Lintun 	M
 Linus 	M
 Linwood 	M
 Lionel 	M
 Lionell 	M
 Liora 	F
 Lioslaith 	F
 Lir 	M
 Liriene 	F
 Lirienne 	F
 Lirit 	F
 Lirita 	F
 Lisa 	F
 Lisabet 	M
 Lisabeth 	F
 Lisabette 	F
 Lisandra 	F
 Lisandro 	M
 Lisavet 	F
 Lisbet 	F
 Lisbeth 	F
 Lise 	F
 Lisette 	F
 Lisha 	F
 Lishan 	F
 Lisle 	M
 Lissa 	F
 Lissette 	F
 Lissie 	F
 Lita 	F
 Litton 	M
 Litzy 	F
 Livana 	F
 Livia 	F
 Livingston 	M
 Livingstone 	M
 Liwanu 	M
 Liz 	F
 Liza 	F
 Lizabeth 	F
 Lizandra 	F
 Lizann 	F
 Lizbet 	F
 Lizbeth 	F
 Lizeth 	F
 Lizette 	F
 Lizzie 	F
 Llacheu 	M
 Llamrei 	F
 Llesenia 	F
 Llewellyn 	M
 Llewelyn 	M
 Lloyd 	M
 Lludd 	M
 Llyr 	M
 Loc 	M
 Lochlain 	M
 Lochlann 	M
 Locke 	M
 Lockie 	F
 Lockwood 	M
 Lodema 	F
 Lodima 	F
 Lodyma 	F
 Loe 	M
 Loefel 	M
 Logan 	M
 Logen 	M
 Logestilla 	F
 Logistilla 	F
 Lohengrin 	M
 Lohoot 	M
 Lois 	F
 Lok 	M
 Lokelani 	F
 Lokni 	M
 Lola 	F
 Loleta 	F
 Lolita 	F
 Lolitta 	F
 Lollie 	F
 Loma 	F
 Lomahongva 	F
 Loman 	M
 Lomasi 	F
 Lon 	M
 Lona 	F
 Lonato 	M
 Lonell 	M
 Loni 	F
 Lonie 	F
 Lonna 	F
 Lonnell 	M
 Lonnie 	M
 Lonny 	M
 Lono 	M
 Lonyn 	F
 Lonzo 	M
 Lootah 	M
 Lora 	F
 Lorah 	M
 Loraina 	F
 Loraine 	F
 Loralei 	F
 Loran 	M
 Lorance 	M
 Loranna 	F
 Lorayne 	F
 Lorcan 	M
 Lorda 	F
 Lore 	F
 Loreen 	F
 Loreene 	F
 Lorelei 	F
 Loren 	M
 Lorena 	F
 Lorence 	M
 Lorene 	F
 Lorenia 	F
 Lorenna 	F
 Lorenz 	M
 Lorenza 	M
 Lorenzo 	M
 Loreta 	F
 Loretta 	F
 Lorette 	M
 Loretto 	F
 Lori 	F
 Loria 	M
 Lorian 	F
 Loriana 	F
 Loriann 	F
 Lorianne 	F
 Lorie 	F
 Loriel 	F
 Lorilee 	F
 Lorilynn 	F
 Lorimar 	M
 Lorimer 	M
 Lorin 	M
 Lorinda 	F
 Lorine 	F
 Loring 	M
 Loris 	F
 Lorita 	F
 Loritz 	M
 Lorna 	F
 Lorne 	M
 Lornell 	M
 Lorraina 	F
 Lorraine 	F
 Lorren 	M
 Lorri 	F
 Lorrie 	F
 Lorrin 	F
 Lorrina 	F
 Loryn 	M
 Lot 	M
 Lota 	F
 Lothair 	M
 Lothar 	M
 Lotharing 	M
 Lotta 	F
 Lotte 	F
 Lottie 	F
 Lotye 	F
 Lou 	F
 Louann 	F
 Louella 	F
 Louetta 	F
 Loughlin 	M
 Louie 	M
 Louis 	M
 Louisa 	F
 Louisane 	F
 Louise 	F
 Loula 	F
 Lourdes 	F
 Louredes 	F
 Louvel 	M
 Louvenia 	F
 Lovell 	M
 Lovie 	F
 Lovina 	F
 Lovisa 	F
 Lowe 	M
 Lowell 	M
 Loy 	M
 Loyal 	M
 Loyce 	F
 Loyd 	M
 Lsss 	F
 Lssse 	F
 Luana 	F
 Luane 	F
 Luann 	F
 Luanne 	F
 Luc 	M
 Luca 	M
 Lucan 	M
 Lucas 	M
 Lucena 	F
 Lucero 	F
 Lucette 	F
 Luci 	F
 Lucia 	F
 Lucian 	M
 Lucianna 	F
 Luciano 	M
 Lucie 	F
 Lucien 	M
 Lucienne 	F
 Lucila 	M
 Lucile 	F
 Lucille 	F
 Lucina 	F
 Lucinda 	F
 Lucio 	M
 Lucious 	M
 Lucita 	F
 Lucius 	M
 Lucrece 	F
 Lucrecia 	F
 Lucretia 	F
 Lucrezia 	F
 Lucy 	F
 Ludie 	F
 Ludkhannah 	F
 Ludlow 	M
 Luduvico 	M
 Ludwig 	M
 Ludwik 	M
 Lue 	F
 Lueius 	M
 Luell 	F
 Luella 	F
 Luete 	F
 Luetta 	F
 Lufian 	M
 Lufti 	M
 Lugaidh 	M
 Lughaidh 	M
 Luighseach 	F
 Luigi 	M
 Luiginw 	M
 Luijzika 	F
 Luis 	M
 Luisa 	F
 Luise 	F
 Luiza 	F
 Lujza 	F
 Lukas 	M
 Luke 	M
 Luki 	M
 Lula 	F
 Lular 	F
 Lulie 	F
 Lulu 	F
 Lum 	M
 Lumumba 	M
 Lun 	M
 Luna 	F
 Lunden 	M
 Lundie 	M
 Lundy 	M
 Luned 	F
 Lunet 	F
 Lunete 	F
 Lunetta 	M
 Lunn 	M
 Lupe 	F
 Lupita 	F
 Lur 	F
 Lura 	F
 Lurleen 	F
 Lurlene 	F
 Lurlina 	F
 Lurline 	F
 Lusala 	M
 Luthais 	M
 Luther 	M
 Lutie 	F
 Lutz 	M
 Luvena 	F
 Luvenia 	F
 Luvina 	F
 Luvyna 	F
 Luxovious 	M
 Luyu 	F
 Luz 	F
 Lyall 	M
 Lyam 	M
 Lyda 	F
 Lydell 	M
 Lydia 	F
 Lyel 	M
 Lyfing 	M
 Lyla 	F
 Lyle 	M
 Lyman 	M
 Lyn 	F
 Lynd 	M
 Lynda 	F
 Lyndall 	F
 Lyndee 	F
 Lyndi 	F
 Lyndon 	M
 Lyndsay 	F
 Lyndsey 	F
 Lyndsie 	M
 Lynelle 	F
 Lynessa 	M
 Lynet 	F
 Lynette 	F
 Lynford 	M
 Lynley 	F
 Lynn 	F
 Lynna 	F
 Lynne 	F
 Lynnet 	F
 Lynnette 	F
 Lynsey 	F
 Lynwood 	M
 Lynzee 	F
 Lynzie 	F
 Lyones 	F
 Lyonesse 	F
 Lyonet 	F
 Lyonette 	F
 Lyonors 	F
 Lyra 	F
 Lysanor 	F
 Lyssa 	F
 Lyvia 	F
 Lyza 	M
 Lyzbeth 	F
 Mab 	F
 Mabbina 	F
 Mabel 	F
 Mabell 	F
 Mabelle 	F
 Mabina 	F
 Mable 	F
 Mabon 	M
 Mabonaqain 	M
 Mabuz 	M
 Mac 	M
 MacAdhamh 	M
 MacAlister 	M
 MacAlpin 	M
 MacAlpine 	M
 MacAndrew 	M
 Macario 	M
 Macartan 	M
 MacArthur 	M
 MacAulay 	M
 MacAuliffe 	M
 MacAuslan 	M
 MacBain 	M
 MacBean 	M
 MacBeth 	M
 MacBride 	M
 MacCallum 	M
 MacClennan 	M
 MacColl 	M
 MacCormack 	M
 Maccus 	M
 MacDaibhidh 	M
 MacDhuBh 	M
 MacDomhnall 	M
 MacDonald 	M
 MacDonell 	M
 MacDougal 	M
 MacDoughall 	M
 MacDubhgall 	M
 MacDuff 	M
 Mace 	M
 Macee 	F
 MacElroy 	M
 Maceo 	M
 Macerio 	M
 MacEwen 	M
 Macey 	F
 MacFarlane 	M
 MacFie 	M
 MacGillivray 	M
 MacGowan 	M
 MacGregor 	M
 Macha 	F
 Machair 	M
 Machakw 	M
 Machar 	M
 Machara 	F
 Machau 	M
 Machelle 	F
 Machk 	M
 Machum 	M
 Machupa 	M
 Maci 	F
 Macie 	F
 MacInnes 	M
 MacIver 	M
 Mack 	M
 MacKay 	M
 MacKendrick 	M
 Mackenzie 	F
 MacKinley 	M
 MacKinnon 	M
 MackIntosh 	M
 Macklin 	M
 Macklyn 	M
 MacLachlan 	M
 MacLaine 	M
 MacLaren 	M
 MacLean 	M
 MacLeod 	M
 MacMaureadhaigh 	M
 MacMillan 	M
 MacMurra 	M
 MacNab 	M
 MacNachtan 	M
 MacNaughton 	M
 MacNeill 	M
 MacNiall 	M
 MacNicol 	M
 MacPherson 	M
 MacQuaid 	M
 MacQuarrie 	M
 MacQueen 	M
 MacRae 	M
 MacRay 	M
 Macy 	F
 Mada 	F
 Madailein 	F
 Madalen 	F
 Madalena 	F
 Madalene 	F
 Madaline 	F
 Madalyn 	F
 Madalynn 	F
 Maddalen 	F
 Maddalena 	F
 Maddalene 	F
 Maddalyn 	F
 Madden 	M
 Maddie 	F
 Maddison 	F
 Maddock 	M
 Maddox 	M
 Maddy 	F
 Madel 	F
 Madelaine 	F
 Madeleina 	F
 Madeleine 	F
 Madelena 	F
 Madelene 	F
 Madelhari 	M
 Madelina 	F
 Madeline 	F
 Madelon 	M
 Madelyn 	F
 Madelynn 	F
 Madena 	F
 Madge 	F
 Madia 	F
 Madie 	F
 Madilyn 	F
 Madina 	F
 Madisen 	F
 Madison 	F
 Madisyn 	F
 Madntyre 	M
 Madolen 	F
 Madonna 	F
 Mador 	M
 Madra 	F
 Madre 	F
 Mads 	M
 Mady 	F
 Madyson 	F
 Mae 	F
 MaeAdam 	M
 Maed 	M
 Maegan 	F
 Maegth 	F
 Maeleachlainn 	M
 Maelee 	F
 Maelisa 	M
 Maelwine 	M
 Maelynn 	F
 Maeret 	M
 Maerewine 	M
 Maertisa 	F
 Maethelwine 	M
 Maetthere 	M
 Maeve 	F
 Maeveen 	F
 Mafalda 	F
 Magan 	M
 Maganhildi 	F
 Magd 	F
 Magda 	F
 Magdala 	F
 Magdalen 	F
 Magdalena 	F
 Magdalene 	F
 Magee 	M
 Magen 	F
 Magena 	F
 Maggi 	F
 Maggie 	F
 Maggy 	F
 Magnhilda 	F
 Magnild 	F
 Magnilda 	F
 Magnilde 	F
 Magnolia 	F
 Magnus 	M
 Mago 	M
 Mahal 	F
 Mahala 	F
 Mahalia 	F
 Mahault 	F
 Maheloas 	M
 Maher 	M
 Mahieu 	M
 Mahina 	F
 Mahir 	M
 Mahkah 	M
 Mahlon 	M
 Mahmoud 	M
 Mahmud 	M
 Mahon 	M
 Mahoney 	M
 Mahpee 	M
 Mai 	F
 Maia 	F
 Maialen 	F
 Maible 	F
 Maichail 	M
 Maida 	F
 Maidel 	F
 Maidie 	F
 Maighdlin 	F
 Mailhairer 	M
 Maille 	F
 Mailsi 	F
 Mainchin 	M
 Maiolaine 	F
 Maira 	F
 Maire 	F
 Mairead 	F
 Mairi 	F
 Mairia 	F
 Mairona 	F
 Maisie 	F
 Maitane 	F
 Maite 	F
 Maitea 	F
 Maitena 	F
 Maiti 	F
 Maitilda 	F
 Maitilde 	F
 Maitland 	M
 Maiya 	F
 Majella 	F
 Majida 	F
 Major 	M
 Majori 	F
 Makaila 	F
 Makala 	F
 Makani 	M
 Makarim 	F
 Makayla 	F
 Makda 	F
 Makeda 	F
 Makeen 	M
 Makemba 	F
 Makena 	F
 Makenna 	F
 Makenzie 	F
 Makin 	M
 Makis 	M
 Makkapitew 	M
 Makkitotosimew 	F
 Makolm 	M
 Makya 	M
 Mal 	M
 Malachi 	M
 Malachy 	M
 Malak 	F
 Malakai 	M
 Malana 	F
 Malcah 	F
 Malcolm 	M
 Malcom 	M
 Maldue 	M
 Maleah 	F
 Malene 	F
 Malia 	F
 Malik 	M
 Malin 	M
 Malina 	F
 Malinda 	F
 Malissa 	F
 Malita 	F
 Maliyah 	F
 Malkah 	F
 Mallaidh 	F
 Malleville 	M
 Mallie 	F
 Mallory 	F
 Malloy 	M
 Malmuira 	F
 Malmuirie 	F
 Malone 	M
 Maloney 	M
 Malvin 	M
 Malvina 	F
 Malvyn 	M
 Malyn 	M
 Mame 	F
 Mamie 	F
 Mammie 	F
 Mana 	F
 Manal 	F
 Manar 	F
 Manara 	F
 Manasses 	M
 Manda 	F
 Mandalyn 	F
 Mandel 	M
 Mandi 	F
 Mandie 	F
 Mandisa 	F
 Mandy 	F
 Manette 	F
 Manford 	M
 Manfred 	M
 Manfrid 	M
 Manfried 	M
 Manfrit 	M
 Mani 	M
 Manie 	F
 Manila 	F
 Manley 	M
 Manly 	M
 Mann 	M
 Manneville 	M
 Mannie 	M
 Manning 	M
 Mannix 	M
 Mannleah 	M
 Mannuss 	M
 Manny 	M
 Mano 	M
 Manoela 	F
 Manolito 	M
 Manolo 	M
 Manon 	F
 Mansfield 	M
 Mansi 	F
 Mantel 	M
 Manton 	M
 Mantotohpa 	M
 Manu 	M
 Manuel 	M
 Manuela 	F
 Manuelo 	M
 Manus 	M
 Manville 	M
 Maola 	F
 Maoli 	F
 Maolmuire 	M
 Maolruadhan 	M
 Maonaigh 	M
 Maponus 	M
 Mara 	F
 Maralah 	F
 Maralyn 	M
 Maranda 	F
 Marc 	M
 Marcail 	F
 Marcas 	M
 Marceau 	M
 Marcel 	M
 Marcela 	F
 Marceline 	F
 Marcelino 	M
 Marcella 	F
 Marcelle 	F
 Marcellia 	F
 Marcello 	M
 Marcellus 	M
 Marcelo 	M
 Marchelle 	F
 Marchland 	M
 Marchman 	M
 Marci 	F
 Marcia 	F
 Marcie 	F
 Marco 	M
 Marcos 	M
 Marcus 	M
 Marcy 	F
 Mardel 	M
 Mardell 	F
 Marden 	M
 Mardon 	M
 Maree 	F
 Mareesa 	F
 Marelda 	F
 Marella 	F
 Maren 	F
 Margaret 	F
 Margarete 	F
 Margaretha 	F
 Margarethe 	F
 Margarett 	F
 Margaretta 	F
 Margarette 	F
 Margarita 	F
 Margarito 	M
 Margaux 	F
 Margawse 	F
 Marge 	F
 Margeaux 	F
 Margerie 	F
 Margery 	F
 Margie 	F
 Margit 	M
 Margo 	F
 Margot 	F
 Margret 	F
 Margrit 	F
 Marguerite 	F
 Margueritta 	F
 Marhilda 	F
 Marhildi 	F
 Mari 	F
 Maria 	F
 Mariadok 	M
 Mariah 	F
 Mariam 	F
 Mariama 	F
 Mariamne 	F
 Marian 	F
 Mariana 	F
 Mariane 	F
 Mariann 	F
 Marianna 	F
 Marianne 	F
 Mariano 	M
 Maribel 	F
 Maribella 	F
 Maribelle 	F
 Maribeth 	F
 Maricel 	F
 Maricela 	F
 Maricelia 	F
 Maricella 	F
 Marid 	M
 Marie 	F
 Mariel 	F
 Mariela 	F
 Mariele 	F
 Marielle 	F
 Marietta 	F
 Mariette 	F
 Marigold 	F
 Marika 	F
 Marilda 	F
 Marilee 	F
 Marilla 	F
 Marilou 	F
 Marily 	F
 Marilyn 	F
 Marilynn 	F
 Marina 	F
 Mariner 	M
 Mario 	M
 Marion 	F
 Mariquita 	F
 Marisa 	F
 Marise 	F
 Marisela 	F
 Marisha 	F
 Mariska 	F
 Marisol 	F
 Marissa 	F
 Marita 	F
 Maritza 	F
 Marjani 	F
 Marji 	M
 Marjo 	F
 Marjolaina 	F
 Marjorie 	F
 Marjory 	F
 Markel 	M
 Markell 	M
 Markey 	M
 Markos 	M
 Markus 	M
 Marla 	F
 Marlaina 	F
 Marlan 	M
 Marlana 	F
 Marland 	M
 Marlayna 	F
 Marlayne 	M
 Marlee 	F
 Marleen 	F
 Marleena 	F
 Marleene 	F
 Marleigh 	M
 Marleina 	F
 Marlena 	F
 Marlene 	F
 Marlenne 	F
 Marley 	F
 Marlina 	F
 Marlinda 	F
 Marline 	M
 Marlis 	F
 Marlisa 	F
 Marliss 	F
 Marlo 	F
 Marlon 	M
 Marlow 	M
 Marlowe 	M
 Marly 	M
 Marlyn 	F
 Marlynn 	F
 Marlys 	F
 Marlyssa 	M
 Marmion 	M
 Marni 	F
 Marnie 	F
 Marnin 	M
 Marq 	M
 Marque 	M
 Marques 	M
 Marquez 	M
 Marquilla 	F
 Marquis 	M
 Marquisa 	F
 Marquise 	M
 Marquisha 	F
 Marquita 	F
 Marrok 	M
 Mars Leucetius 	M
 Marschall 	M
 Marsden 	M
 Marsh 	M
 Marsha 	F
 Marshal 	M
 Marshall 	M
 Marsten 	M
 Marston 	M
 Mart 	M
 Marta 	F
 Marteena 	F
 Martel 	M
 Martell 	M
 Martha 	F
 Marthe 	F
 Martin 	M
 Martina 	F
 Martinez 	M
 Martino 	M
 Marty 	M
 Martyn 	M
 Marva 	F
 Marveille 	F
 Marvel 	F
 Marvella 	F
 Marvelle 	F
 Marven 	M
 Marvin 	M
 Marvina 	F
 Marvyn 	M
 Marwin 	M
 Marwood 	M
 Marx 	M
 Mary 	F
 Maryam 	F
 Maryan 	F
 Maryann 	F
 Maryanna 	F
 Maryanne 	F
 Marybell 	M
 Marybelle 	F
 Marybeth 	F
 Maryellen 	F
 Maryjane 	F
 Maryjo 	F
 Maryl 	F
 Marylee 	F
 Marylin 	F
 Marylou 	F
 Marylu 	M
 Marylyn 	F
 Marylynn 	F
 Maryon 	F
 Masao 	M
 Masichuvio 	M
 Maska 	M
 Maskini 	M
 Maslin 	M
 Mason 	M
 Massassi 	F
 Masselin 	M
 Massima 	F
 Masson 	M
 Masud 	M
 Matai 	M
 Matata 	M
 Matchitehew 	M
 Matchitisiw 	M
 Matea 	F
 Mateo 	M
 Mathani 	M
 Mathe 	M
 Mathea 	F
 Mather 	M
 Mathers 	M
 Matherson 	M
 Matheson 	M
 Mathew 	M
 Mathews 	M
 Mathia 	F
 Mathias 	M
 Mathieu 	M
 Mathild 	F
 Mathilda 	F
 Mathilde 	F
 Matias 	M
 Matie 	F
 Matilda 	F
 Matilde 	F
 Matin 	M
 Matoskah 	M
 Matro 	M
 Matt 	M
 Mattea 	F
 Matteo 	M
 Matthea 	F
 Matthew 	M
 Matthia 	F
 Matthias 	M
 Matthieu 	M
 Mattias 	M
 Mattie 	F
 Matty 	F
 Matunaagd 	M
 Matunde 	M
 Matwau 	M
 Matxalen 	F
 Matyas 	M
 Matz 	M
 Maud 	F
 Maude 	F
 Maudie 	F
 Maughold 	M
 Maunfeld 	M
 Maura 	F
 Maureen 	F
 Maurelle 	F
 Maureo 	M
 Maurice 	M
 Mauricio 	M
 Maurina 	F
 Maurine 	F
 Maurizio 	M
 Mauro 	M
 Maury 	M
 Maurya 	F
 Mausi 	F
 Mava 	F
 Mave 	F
 Mavelle 	F
 Maverick 	M
 Mavie 	F
 Mavis 	F
 Mavise 	F
 Mavrick 	M
 Mawunyaga 	F
 Max 	M
 Maxfield 	M
 Maxie 	M
 Maxim 	M
 Maxime 	M
 Maximilian 	M
 Maximillian 	M
 Maximus 	M
 Maxine 	F
 Maxwell 	M
 Maya 	F
 Mayah 	F
 Maybell 	F
 Maybelle 	F
 Mayda 	F
 Mayde 	F
 Maye 	F
 Mayer 	M
 Mayfield 	M
 Mayhew 	M
 Mayir 	M
 Maylea 	F
 Mayme 	F
 Maymie 	F
 Maynard 	M
 Mayne 	M
 Maynor 	M
 Mayra 	F
 Maysa 	F
 Maysun 	F
 Maza blaska 	M
 Mazel 	F
 Mazie 	F
 Mcarthur 	M
 McCloud 	M
 Mccoy 	M
 McKayla 	F
 McKenna 	F
 McKenzie 	F
 McKinley 	M
 Mead 	M
 Meade 	M
 Meadghbh 	F
 Meadhbh 	F
 Meadhra 	M
 Meadow 	F
 Meagan 	F
 Meaghan 	F
 Mealcoluim 	M
 Meara 	M
 Mearl 	M
 Mearr 	F
 Meccus 	M
 Mechelle 	F
 Meda 	F
 Medb 	F
 Media 	F
 Medina 	F
 Medredydd 	M
 Medwin 	M
 Medwine 	M
 Medwyn 	M
 Meeda 	F
 Meg 	F
 Megan 	F
 Megdn 	F
 Megedagik 	M
 Meghan 	F
 Meghann 	F
 Mehemet 	M
 Mehetabel 	F
 Meheytabel 	F
 Mehitahelle 	F
 Mei 	F
 Meilseoir 	M
 Meinhard 	M
 Meinke 	M
 Meino 	M
 Meinrad 	M
 Meinyard 	M
 Meir 	M
 Meira 	F
 Meka 	F
 Mekhi 	M
 Mekledoodum 	M
 Mekonnen 	M
 Mel 	M
 Melaina 	F
 Melaine 	F
 Melanee 	F
 Melanie 	F
 Melany 	F
 Melba 	F
 Melborn 	M
 Melbourne 	M
 Melburn 	M
 Melbyrne 	M
 Melchoir 	M
 Meldon 	M
 Meldrick 	M
 Meldrik 	M
 Meldryk 	M
 Meleagant 	M
 Melechan 	M
 Melek 	F
 Melesse 	M
 Melia 	F
 Meliadus 	M
 Melina 	F
 Melinda 	F
 Meliodas 	M
 Melisa 	F
 Melisande 	F
 Melisenda 	F
 Melissa 	F
 Melita 	F
 Mellie 	F
 Mellisa 	F
 Mellissa 	F
 Melodie 	F
 Melody 	F
 Melonie 	F
 Melosa 	F
 Melosia 	F
 Melrone 	M
 Melton 	M
 Melusina 	F
 Melva 	F
 Melville 	M
 Melvin 	M
 Melvina 	F
 Melvon 	M
 Melvyn 	M
 Melwas 	M
 Melynda 	F
 Melyon 	M
 Memdi 	F
 Menachem 	M
 Menachema 	F
 Menachemah 	F
 Menassah 	M
 Mendi 	F
 Mendy 	F
 Menelik 	M
 Mensah 	M
 Menw 	M
 Menzies 	M
 Meoquanee 	F
 Mercede 	F
 Mercedes 	F
 Mercer 	M
 Merci 	F
 Mercia 	F
 Mercie 	F
 Mercilla 	F
 Mercina 	F
 Mercy 	F
 Meredith 	F
 Merestun 	M
 Merewode 	M
 Merewood 	M
 Meri 	F
 Meridel 	F
 Meriel 	F
 Merilyn 	F
 Merl 	M
 Merla 	M
 Merle 	M
 Merlene 	F
 Merlin 	M
 Merlion 	M
 Merlow 	M
 Merlyn 	M
 Merna 	F
 Merri 	F
 Merrie 	F
 Merril 	M
 Merrilee 	F
 Merrill 	M
 Merritt 	M
 Merryl 	F
 Mersc 	M
 Mertice 	F
 Mertie 	F
 Mertise 	F
 Merton 	M
 Mertysa 	F
 Mervin 	M
 Mervyn 	M
 Merwin 	M
 Merwyn 	M
 Meryl 	F
 Meta 	F
 Metta 	F
 Mettabel 	F
 Mettie 	F
 Meturato 	M
 Meyer 	M
 Mia 	F
 Miah 	F
 Miakoda 	F
 Micaela 	F
 Micah 	M
 Mical 	F
 Michael 	M
 Michaela 	F
 Michaele 	F
 Michaelina 	F
 Michaeline 	F
 Michaelyn 	F
 Michal 	M
 Michale 	M
 Michalin 	F
 Micheal 	M
 Micheala 	F
 Michel 	M
 Michela 	F
 Michelangelo 	M
 Michele 	F
 Micheline 	F
 Michell 	F
 Michella 	F
 Michelle 	F
 Michon 	M
 Mick 	M
 Mickayla 	F
 Mickey 	M
 Mickie 	F
 Micky 	M
 Micole 	F
 Mide 	F
 Mieze 	F
 Migdalia 	F
 Migisi 	F
 Mignon 	F
 Mignonette 	F
 Miguel 	M
 Mihaly 	M
 Mika 	M
 Mikael 	M
 Mikaela 	F
 Mikala 	F
 Mikayla 	F
 Mike 	M
 Mikel 	M
 Mikele 	F
 Mikella 	F
 Mikelle 	F
 Mikhail 	M
 Mikhalis 	M
 Mikhos 	M
 Mikil 	F
 Mikkel 	M
 Mikki 	F
 Mikko 	M
 Milagritos 	F
 Milagros 	F
 Milagrosa 	F
 Milap 	M
 Milburn 	M
 Milbyrne 	M
 Milcah 	F
 Mildraed 	F
 Mildred 	F
 Mildrid 	F
 Mildryd 	F
 Milford 	M
 Miliani 	F
 Millard 	M
 Millen 	M
 Miller 	M
 Millicent 	F
 Millicente 	F
 Millie 	F
 Millman 	M
 Milman 	M
 Milo 	M
 Milton 	M
 Milward 	M
 Mima 	F
 Mimi 	F
 Min 	F
 Mina 	F
 Minal 	F
 Minda 	F
 Mindi 	F
 Mindie 	F
 Mindy 	F
 Minerva 	F
 Minetta 	F
 Minette 	F
 Ming Ue 	F
 Mingan 	M
 Minna 	F
 Minne 	F
 Minnie 	F
 Minninnewah 	M
 Minta 	F
 Mintie 	F
 Miquel 	M
 Mira 	F
 Mirabella 	F
 Mirabelle 	F
 Miracle 	F
 Miranda 	F
 Mirari 	F
 Mireille 	F
 Miren 	F
 Mireya 	F
 Miri 	F
 Miriam 	F
 Mirit 	F
 Mirla 	F
 Mirna 	F
 Miruts 	M
 Misael 	M
 Misi 	M
 Miska 	M
 Misrak 	F
 Missie 	F
 Missouri 	F
 Missy 	F
 Misti 	F
 Mistie 	M
 Mistique 	F
 Misty 	F
 Misu 	M
 Mitcbel 	M
 Mitch 	M
 Mitchel 	M
 Mitchell 	M
 Mittie 	F
 Mitzi 	F
 Moana 	F
 Mochni 	M
 Modesta 	F
 Modeste 	F
 Modig 	M
 Modraed 	M
 Modred 	M
 Modron 	F
 Moe 	M
 Mogens 	M
 Mogue 	M
 Mohamad 	M
 Mohamed 	M
 Mohamet 	M
 Mohammad 	M
 Mohammed 	M
 Moibeal 	F
 Moina 	F
 Moira 	F
 Moire 	F
 Moireach 	F
 Moises 	M
 Mojag 	M
 Mokatavatah 	M
 Moke 	M
 Moketavato 	M
 Moketaveto 	M
 Moketoveto 	M
 Moki 	M
 Mokovaoto 	M
 Molan 	M
 Molara 	F
 Molimo 	M
 Molli 	M
 Mollie 	F
 Molloy 	M
 Molly 	F
 Mona 	F
 Monca 	F
 Moncha 	F
 Moncreiffe 	M
 Mongo 	M
 Mongwau 	M
 Monica 	F
 Monifa 	F
 Monika 	F
 Moniqua 	F
 Monique 	F
 Monnie 	F
 Monohan 	M
 Monroe 	M
 Monserrat 	F
 Mont 	M
 Montae 	M
 Montague 	M
 Montaigu 	M
 Montaine 	M
 Montana 	F
 Montay 	M
 Monte 	M
 Montel 	M
 Montes 	M
 Montez 	M
 Montgomery 	M
 Montie 	M
 Montrel 	M
 Montrell 	M
 Montrelle 	M
 Monty 	M
 Moody 	M
 Mooney 	M
 Moor 	M
 Moore 	M
 Mor 	F
 Mora 	F
 Morain 	M
 Moran 	M
 Morcades 	F
 Mordecai 	M
 Mordechai 	M
 Mordrain 	M
 Mordred 	M
 Moreen 	F
 Moreland 	M
 Moreley 	M
 Morell 	M
 Morella 	F
 Morenike 	M
 Morfran 	M
 Morgan 	F
 Morgan Tud 	M
 Morgana 	F
 Morgance 	F
 Morgane 	F
 Morgawse 	F
 Morgayne 	F
 Morguase 	F
 Morholt 	M
 Mori 	M
 Moriah 	F
 Moriarty 	M
 Morice 	F
 Moriel 	F
 Morisa 	F
 Morise 	F
 Morissa 	F
 Morit 	F
 Morland 	M
 Morlee 	M
 Morly 	M
 Morna 	F
 Morogh 	M
 Morold 	M
 Morrey 	M
 Morrie 	M
 Morrigan 	F
 Morrin 	F
 Morris 	M
 Morrisey 	M
 Morrison 	M
 Morrissey 	M
 Morse 	M
 Mortimer 	M
 Morton 	M
 Morven 	M
 Morvyn 	M
 Moryn 	M
 Mose 	M
 Moselle 	F
 Moses 	M
 Moshe 	M
 Mosheh 	M
 Mosi 	M
 Moss 	M
 Mossie 	F
 Motavato 	M
 Motega 	M
 Moukib 	M
 Moulton 	M
 Moya 	F
 Moyna 	F
 Moyo 	M
 Mozell 	F
 Mozelle 	F
 Muadhnait 	F
 Muata 	M
 Mudawar 	M
 Mufidy 	M
 Muhammad 	M
 Muhammed 	M
 Muhunnad 	M
 Muiel 	F
 Muir 	M
 Muira 	F
 Muircheartaigh 	M
 Muire 	F
 Muireadhach 	M
 Muireann 	F
 Muirfinn 	M
 Muirgheal 	F
 Muirne 	F
 Mukhtar 	M
 Mukki 	M
 Mukonry 	M
 Mulcahy 	M
 Muna 	F
 Mundy 	M
 Mungo 	M
 Munir 	M
 Munro 	M
 Munroe 	M
 Muraco 	M
 Murchadh 	M
 Murdoc 	M
 Murdoch 	M
 Murdock 	M
 Mureithi 	M
 Murel 	F
 Muriel 	F
 Murl 	M
 Murphey 	M
 Murphy 	M
 Murray 	M
 Murrough 	M
 Murry 	M
 Murtagh 	M
 Murtaugh 	M
 Musa 	M
 Musetta 	F
 Musette 	F
 Mwita 	M
 Mya 	F
 Myah 	F
 Mychaela 	F
 Mychal 	F
 Mychele 	F
 Mychelle 	F
 Myer 	M
 Myesha 	F
 Myeshia 	M
 Myla 	F
 Myleen 	F
 Myles 	M
 Mylnburne 	M
 Mylnric 	M
 Mylo 	M
 Myma 	F
 Mynogan 	M
 Myra 	F
 Myranda 	F
 Myriam 	F
 Myrl 	F
 Myrla 	F
 Myrle 	F
 Myrna 	F
 Myron 	M
 Myrta 	F
 Myrtice 	F
 Myrtie 	F
 Myrtis 	F
 Myrtle 	F
 Mystee 	F
 Mysti 	F
 Naal 	M
 Naalnish 	M
 Naalyehe ya sidahi 	M
 Naamah 	F
 Naaman 	M
 Naamit 	F
 Naava 	F
 Naavah 	F
 Nabi Ulmalhamsh 	M
 Nabil 	M
 Nachman 	M
 Nachton 	M
 Nada 	F
 Nadav 	M
 Nadeen 	F
 Nadetta 	F
 Nadette 	F
 Nadia 	F
 Nadie 	F
 Nadif 	M
 Nadifa 	F
 Nadim 	M
 Nadina 	F
 Nadine 	F
 Nadir 	M
 Nadiv 	M
 Nadja 	F
 Nadra 	F
 Naftali 	M
 Naftalie 	M
 Nahcomence 	M
 Nahele 	M
 Nahiossi 	M
 Nahum 	M
 Naiara 	F
 Nainsi 	F
 Nairna 	F
 Nairne 	M
 Najee 	M
 Najjar 	M
 Nakia 	F
 Nakisha 	F
 Nalani 	F
 Nalda 	F
 Naldo 	M
 Nally 	M
 Namid 	F
 Nan 	F
 Nana 	F
 Nancey 	F
 Nanci 	F
 Nancie 	F
 Nancsi 	F
 Nancy 	F
 Nanelia 	F
 Nanelle 	F
 Nanetta 	F
 Nanette 	F
 Nani 	F
 Nanie 	F
 Nanine 	F
 Nann 	M
 Nanna 	F
 Nannette 	F
 Nannie 	F
 Nanon 	F
 Nantres 	M
 Naois 	M
 Naoma 	F
 Naomhan 	M
 Naomi 	F
 Napayshni 	M
 Napier 	M
 Napoleon 	M
 Nara 	F
 Narcisa 	F
 Nardo 	M
 Nareen 	F
 Nareena 	F
 Nareene 	F
 Narve 	M
 Nash 	M
 Nashota 	F
 Nasim 	M
 Nasir 	M
 Nasser 	M
 Nassor 	M
 Nastas 	M
 Nat 	M
 Nata 	F
 Natal 	M
 Natala 	F
 Natalee 	F
 Natalia 	F
 Natalie 	F
 Natalii 	F
 Natalio 	M
 Nataly 	F
 Natanael 	M
 Nataniel 	M
 Natasha 	F
 Nate 	M
 Nathair 	M
 Nathaira 	F
 Nathalee 	F
 Nathalia 	M
 Nathalie 	F
 Nathaly 	F
 Nathan 	M
 Nathanael 	M
 Nathania 	F
 Nathanial 	M
 Nathaniel 	M
 Nathara 	F
 Nathen 	M
 Nathrach 	M
 Nathraichean 	M
 Natividad 	F
 Natuche 	F
 Naughton 	M
 Navarre 	M
 Navarro 	M
 Navit 	F
 Nawar 	F
 Nawat 	M
 Nawkaw 	M
 Nayati 	M
 Nayeli 	F
 Ndulu 	M
 Neakail 	M
 Neal 	M
 Neala 	F
 Neale 	M
 Nealie 	F
 Nealon 	M
 Nearra 	F
 Neason 	M
 Nechama 	F
 Nechemya 	M
 Nechtan 	M
 Nechten 	M
 Ned 	M
 Neda 	F
 Nedda 	F
 Nediva 	F
 Nedivah 	F
 Nedra 	F
 Neeheeoeewootis 	M
 Neelie 	F
 Neely 	F
 Neema 	F
 Neese 	M
 Nef 	M
 Nefen 	M
 Neff 	M
 Nefin 	M
 Negash 	M
 Negasi 	M
 Negus 	M
 Nehama 	F
 Nehanda 	F
 Nehemiah 	M
 Neil 	M
 Neila 	F
 Neilan 	M
 Neill 	M
 Neiva 	F
 Neka 	M
 Nekana 	F
 Nekane 	F
 Nelda 	F
 Nelia 	F
 Nelida 	F
 Nell 	F
 Nella 	F
 Nelle 	F
 Nellie 	F
 Nellwyn 	F
 Nelly 	F
 Nels 	M
 Nelson 	M
 Nelwin 	F
 Nelwina 	F
 Nelwyna 	F
 Nemausus 	M
 Nemesio 	M
 Nena 	F
 Nentres 	M
 Neoma 	F
 Neomi 	F
 Neorah 	F
 Nerea 	F
 Nerian 	M
 Neron 	M
 Nerthus 	F
 Ness 	M
 Nessa 	F
 Nessan 	M
 Nessia 	F
 Nesto 	M
 Nestor 	M
 Neta 	F
 Nethanel 	M
 Neto 	M
 Netta 	F
 Nettie 	F
 Netty 	F
 Neuveville 	M
 Neva 	F
 Nevada 	F
 Nevaeh 	F
 Nevan 	M
 Neville 	M
 Nevyn 	M
 Newell 	M
 Newland 	M
 Newlin 	M
 Newlyn 	M
 Newman 	M
 Newt 	M
 Newton 	M
 Nia 	F
 Niall 	M
 Niallan 	M
 Nicanor 	M
 Nicanora 	F
 Nichele 	F
 Nichelle 	F
 Nichol 	F
 Nicholas 	M
 Nicholaus 	M
 Nichole 	F
 Nicia 	F
 Nick 	M
 Nicki 	F
 Nickie 	F
 Nickolas 	M
 Nickolaus 	M
 Nickson 	M
 Nicky 	M
 Nico 	M
 Nicol 	M
 Nicola 	F
 Nicolaas 	M
 Nicolas 	M
 Nicole 	F
 Nicolette 	F
 Nicolle 	F
 Nicson 	M
 Niel 	M
 Niels 	M
 Nielsine 	F
 Nieve 	F
 Niewheall 	M
 Nigan 	M
 Nigel 	M
 Nighean 	F
 Nighinn 	F
 Niguel 	M
 Niichaad 	M
 Nijel 	M
 Nijlon 	F
 Nikhil 	M
 Niki 	F
 Nikia 	F
 Nikita 	F
 Nikiti 	M
 Nikki 	F
 Nikkie 	F
 Nikko 	M
 Niko 	M
 Nikolas 	M
 Nikolaus 	M
 Nikole 	F
 Nikos 	M
 Nikson 	M
 Nila 	F
 Niles 	M
 Nili 	F
 Nils 	M
 Nimiane 	F
 Nimue 	F
 Nin 	F
 Nina 	F
 Ninacska 	F
 Ninette 	F
 Nineve 	F
 Nini 	F
 Ninon 	F
 Nira 	F
 Niria 	F
 Nirit 	F
 Nisien 	M
 Nissim 	M
 Nita 	F
 Nitis 	M
 Nittawosew 	F
 Nituna 	F
 Nitza 	F
 Nitzanah 	F
 Nixen 	M
 Nixie 	F
 Nixkamich 	M
 Nixon 	M
 Niyol 	M
 Nizana 	F
 Njau 	M
 Nkrumah 	M
 Noach 	M
 Noah 	M
 Nodens 	M
 Nodin 	M
 Nodons 	M
 Noe 	M
 Noel 	M
 Noelani 	F
 Noele 	F
 Noelia 	F
 Noell 	M
 Noella 	F
 Noelle 	F
 Noemi 	F
 Noemie 	F
 Noga 	F
 Nokomis 	F
 Nola 	F
 Nolan 	M
 Noland 	M
 Nolen 	M
 Nolene 	F
 Nolyn 	M
 Noma 	F
 Nona 	F
 Nonie 	F
 Nootau 	M
 Nora 	F
 Norabel 	F
 Norah 	F
 Norberaht 	F
 Norbert 	M
 Norberta 	F
 Norberte 	F
 Norberto 	M
 Norcross 	M
 Nordica 	F
 Nordika 	F
 Noreen 	F
 Noreena 	F
 Noreis 	M
 Norene 	F
 Norice 	M
 Norine 	F
 Norma 	F
 Norman 	M
 Normand 	M
 Normando 	M
 Norris 	M
 Northclif 	M
 Northcliffe 	M
 Northclyf 	M
 Northrop 	M
 Northrup 	M
 Northtun 	M
 Northwode 	M
 Nortin 	M
 Norton 	M
 Norval 	M
 Norvel 	M
 Norville 	M
 Norvin 	M
 Norvyn 	M
 Norward 	M
 Norwel 	M
 Norwell 	M
 Norwin 	M
 Norwood 	M
 Norwyn 	M
 Nosh 	M
 Noshi 	M
 Nouel 	M
 Nova 	F
 Novella 	F
 Nowa 	F
 Noy 	F
 Nuala 	F
 Nudar 	F
 Nudara 	F
 Nudd 	M
 Nukpana 	M
 Nulte 	M
 Nulty 	M
 Numees 	F
 Nuna 	F
 Nunzio 	M
 Nur 	M
 Nura 	F
 Nureet 	F
 Nuri 	M
 Nurit 	F
 Nurita 	F
 Nuru 	F
 Nusa 	F
 Nusi 	F
 Nuttah 	F
 Nweh 	F
 Nya 	F
 Nyah 	F
 Nyasia 	F
 Nyasore 	M
 Nye 	M
 Nygel 	M
 Nykko 	M
 Nyla 	F
 Nyle 	M
 Nyles 	M
 Nynette 	F
 Nyneve 	F
 Oakden 	M
 Oakes 	M
 Oakley 	M
 Obadiah 	M
 Obasi 	M
 Obax 	F
 Obediah 	M
 Obharnait 	F
 Obi 	M
 Obie 	M
 Obike 	M
 O'Brian 	M
 O'Brien 	M
 Ocelfa 	M
 Ocie 	F
 Octavia 	F
 Octavio 	M
 Octe 	M
 Octha 	M
 Ocumwhowurst 	M
 Ocunnowhurst 	M
 Ocvran 	M
 Oda 	F
 Odahingum 	F
 Odakota 	M
 Odale 	M
 Odam 	M
 Odanda 	F
 Odanodan 	M
 Odayle 	M
 Odbart 	M
 Oded 	M
 Odeda 	F
 Odede 	F
 Odel 	M
 Odeletta 	F
 Odelette 	F
 Odelia 	F
 Odelina 	F
 Odelinda 	F
 Odell 	M
 Odella 	F
 Odelyn 	F
 Odelyna 	F
 Odero 	M
 Odessa 	F
 Odette 	F
 Odhert 	M
 Odhran 	M
 Odi 	M
 Odiana 	F
 Odiane 	F
 Odie 	M
 Odila 	F
 Odile 	F
 Odilia 	F
 Odin 	M
 Odion 	M
 Odis 	M
 Odo 	M
 Odom 	M
 Odon 	M
 Odran 	M
 Odwolf 	M
 Odwolfe 	M
 Odwulf 	M
 Ody 	M
 Oegelsby 	M
 Oengus 	M
 Ofelia 	F
 Ofer 	M
 Offa 	M
 Ofra 	F
 Ogaleesha 	M
 Ogden 	M
 Ogdon 	M
 Ogelsby 	M
 Ogelsvie 	M
 Ogelsvy 	M
 Ogilhinn 	M
 Ogilvie 	M
 Ogin 	F
 Ohanko 	M
 Ohanzee 	M
 Ohcumgache 	M
 Ohitekah 	M
 Ohnicio 	F
 Oidhche 	M
 Oifa 	F
 Oihane 	F
 Oilbhe 	F
 Oilell 	F
 Oke 	M
 O'Keefe 	M
 Okelani 	F
 Okes 	M
 Okey 	M
 Okhmhaka 	M
 Ola 	F
 Olaf 	M
 Olan 	M
 Olathe 	F
 Oldwin 	F
 Oldwina 	F
 Oldwyn 	F
 Ole 	M
 Oleda 	F
 Olen 	M
 Oleta 	F
 Oletha 	F
 Olevia 	F
 Olexa 	F
 Olga 	F
 Oliana 	F
 Olie 	F
 Olimpia 	F
 Olin 	M
 Olina 	F
 Olinda 	F
 Oline 	F
 Oliphant 	M
 Olita 	F
 Olive 	F
 Oliver 	M
 Oliveria 	F
 Oliverio 	M
 Oliverios 	M
 Olivia 	F
 Olivier 	M
 Ollaneg 	M
 Olney 	M
 Olwen 	F
 Olwyn 	F
 Olympe 	F
 Olympia 	F
 Oma 	F
 Omah 	F
 Omar 	M
 Omari 	M
 Omarion 	M
 Omat 	F
 Omawnakw 	M
 Omeet 	M
 Omer 	M
 Omet 	M
 Omette 	F
 Omie 	F
 Ominotago 	F
 Ommar 	M
 Ona 	F
 Onaedo 	F
 Onawa 	F
 Oneal 	M
 Onfroi 	M
 Onida 	F
 Onie 	F
 ONille 	M
 Onit 	F
 Onora 	F
 Onslow 	M
 Onslowe 	M
 Oona 	F
 Oonagh 	F
 Oota dabun 	F
 Opal 	F
 Ophelia 	F
 Ophelie 	F
 Ophra 	F
 Ophrah 	F
 Oprah 	F
 Ora 	F
 Orabel 	F
 Orabelle 	F
 Orah 	F
 Orahamm 	M
 Oralee 	F
 Orali 	F
 Oralia 	F
 Oralie 	F
 Oram 	M
 Oran 	M
 Orane 	F
 Ord 	M
 Ordman 	M
 Ordmund 	M
 Ordsone 	M
 Ordwald 	M
 Ordway 	M
 Ordwin 	M
 Ordwine 	M
 Orelia 	F
 Oren 	M
 Orford 	M
 Orghlaith 	F
 Orguelleuse 	F
 Orham 	M
 Ori 	M
 Oria 	F
 Oriana 	F
 Orick 	M
 Orie 	M
 Oriel 	F
 Orik 	M
 Orin 	M
 Orion 	M
 Oris 	M
 Orla 	M
 Orlaith 	F
 Orlaithe 	F
 Orlan 	M
 Orland 	M
 Orlando 	M
 Orlee 	F
 Orlege 	M
 Orlena 	F
 Orlene 	F
 Orley 	M
 Orlin 	M
 Orlina 	F
 Orlo 	M
 Orlondo 	M
 Orman 	M
 Ormeman 	M
 Ormemund 	M
 Ormod 	M
 Ormond 	M
 Ormund 	M
 Ornetta 	F
 Oro 	M
 Orpha 	F
 Orquidea 	F
 Orquidia 	F
 Orran 	M
 Orren 	M
 Orrick 	M
 Orrie 	M
 Orrik 	M
 Orrin 	M
 Orsen 	M
 Orson 	M
 Orton 	M
 Ortun 	M
 Orva 	F
 Orval 	M
 Orvelle 	M
 Orvil 	M
 Orville 	M
 Orvin 	M
 Orvyn 	M
 Orwald 	M
 Orzora 	F
 Orzsebet 	F
 Osa 	F
 Osana 	F
 Osane 	F
 Osbart 	M
 Osbeorht 	M
 Osberga 	F
 Osbert 	M
 Osborn 	M
 Osborne 	M
 Osbourne 	M
 Osburga 	F
 Osburn 	M
 Osburt 	M
 Oscar 	M
 Osckar 	M
 O'Shay 	M
 O'Shea 	M
 Osie 	F
 Osip 	M
 Oskar 	M
 Osker 	M
 Osman 	M
 Osmar 	M
 Osmarr 	M
 Osmin 	M
 Osmond 	M
 Osmont 	M
 Osmund 	M
 Osraed 	M
 Osred 	M
 Osric 	M
 Osrick 	M
 Osrid 	M
 Osrik 	M
 Osryd 	M
 Ossian 	M
 Ossie 	F
 Osvaldo 	M
 Oswald 	M
 Oswaldo 	M
 Osweald 	M
 Oswell 	M
 Oswin 	M
 Oswine 	M
 Oswiu 	M
 Oswy 	M
 Otaktay 	M
 Otelia 	F
 Otha 	M
 Othili 	F
 Othman 	M
 Othmann 	M
 Otho 	M
 Othomann 	M
 Otilie 	F
 Otis 	M
 Otka 	F
 Otoahhastis 	M
 Otoahnacto 	M
 Ottavia 	F
 Otthild 	F
 Otthilda 	F
 Otthilde 	F
 Ottie 	F
 Ottila 	F
 Ottilia 	F
 Ottilie 	F
 Ottis 	M
 Otto 	M
 Ottokar 	M
 Otylia 	F
 Ouida 	F
 Ouray 	M
 Ourson 	M
 Ova 	F
 Ovadiah 	M
 Ovadya 	M
 Ove 	F
 Oved 	M
 Ovid 	M
 Owain 	M
 Owen 	M
 Owin 	M
 Owyn 	M
 Oxa 	M
 Oxford 	M
 Oxley 	M
 Oxnaford 	M
 Oxnaleah 	M
 Oxnatun 	M
 Oxton 	M
 Ozella 	F
 Ozi 	M
 Ozzi 	M
 Ozzie 	M
 Pabla 	F
 Pablo 	M
 Pacho 	M
 Pachu'a 	M
 Paciencia 	F
 Paco 	M
 Pacorro 	M
 Paden 	M
 Padgett 	M
 Padraic 	M
 Padraig 	M
 Padraigin 	F
 Padriac 	M
 Padric 	M
 Padruig 	M
 Paegastun 	M
 Paella 	M
 Page 	M
 Paget 	M
 Pahana 	M
 Paien 	M
 Paige 	F
 Paili 	F
 Paine 	M
 Pakwa 	F
 Palamedes 	M
 Palba 	F
 Palban 	M
 Palben 	M
 Pall 	F
 Pallaton 	M
 Palma 	F
 Palmer 	M
 Palmere 	M
 Palmira 	F
 Paloma 	F
 Palomydes 	M
 Palsmedes 	M
 Palt el 	M
 Palti 	M
 Pam 	F
 Pamala 	F
 Pamela 	F
 Pamella 	F
 Pancho 	M
 Panya 	M
 Paola 	F
 Paolo 	M
 Paquita 	F
 Parker 	M
 Parkin 	M
 Parkins 	M
 Parkinson 	M
 Parlan 	M
 Parnall 	M
 Parnel 	M
 Parnell 	M
 Parnella 	F
 Parrish 	M
 Parsefal 	M
 Parsifal 	M
 Parthenia 	F
 Pascal 	M
 Pascala 	F
 Pascale 	F
 Pascaline 	F
 Paschal 	M
 Pasclina 	F
 Pascual 	M
 Pascuale 	M
 Pasqual 	M
 Pasquale 	M
 Pastora 	F
 Patamon 	M
 Patience 	F
 Paton 	M
 Patric 	M
 Patrica 	F
 Patrice 	F
 Patricia 	F
 Patricio 	M
 Patrick 	M
 Patrido 	M
 Patrizia 	F
 Patrizio 	M
 Patten 	M
 Patti 	F
 Pattie 	F
 Pattin 	M
 Patton 	M
 Patty 	F
 Patwin 	M
 Paul 	M
 Paula 	F
 Pauletta 	F
 Paulette 	F
 Paulina 	F
 Pauline 	F
 Paulita 	F
 Paulo 	M
 Pauloc 	M
 Paulson 	M
 Pauwau 	F
 Pavati 	F
 Pax 	M
 Paxton 	M
 Paxtun 	M
 Payat 	M
 Payatt 	M
 Payden 	M
 Payne 	M
 Paytah 	M
 Payton 	F
 Paz 	M
 Paza 	F
 Pazia 	F
 Pazice 	F
 Pazit 	F
 Peada 	M
 Pearce 	M
 Pearl 	F
 Pearle 	F
 Pearlie 	F
 Pearline 	F
 Pearroc 	M
 Pearson 	M
 Pedar 	M
 Pedra 	F
 Pedro 	M
 Peggie 	F
 Peggy 	F
 Peirce 	M
 Pell 	M
 Pellam 	M
 Pellanor 	M
 Pellean 	M
 Pelleas 	M
 Pelles 	M
 Pellinore 	M
 Pelltun 	M
 Pemton 	M
 Penarddun 	F
 Penda 	M
 Pendragon 	M
 Penelope 	F
 Penina 	F
 Peninah 	F
 Penleigh 	M
 Penley 	M
 Penn 	M
 Penni 	F
 Pennie 	F
 Pennleah 	M
 Penrith 	M
 Penrod 	M
 Pensee 	F
 Penton 	M
 Pepe 	M
 Pepillo 	M
 Pepin 	M
 Pepita 	F
 Pepperell 	M
 Peppi 	M
 Peppin 	M
 Perahta 	F
 Perceval 	M
 Percival 	M
 Percy 	M
 Percyvelle 	M
 Peredwus 	M
 Peregrine 	M
 Perekin 	M
 Perfecta 	F
 Perke 	F
 Perkin 	M
 Perkins 	M
 Perkinson 	M
 Perla 	F
 Perley 	M
 Pernel 	M
 Pernell 	M
 Perren 	M
 Perrin 	M
 Perry 	M
 Perryn 	M
 Pershing 	M
 Perth 	M
 Perye 	M
 Perzsi 	F
 Perzsike 	F
 Pesach 	M
 Pessach 	M
 Peta 	F
 Pete 	M
 Peter 	M
 Peterson 	M
 Petra 	F
 Petronilla 	F
 Petronille 	F
 Petrus 	M
 Petunia 	F
 Peverell 	M
 Peyton 	F
 Pfeostun 	M
 PfessSley 	M
 Phebe 	F
 Phelan 	M
 Phelps 	M
 Pherson 	M
 Phiala 	F
 Phil 	M
 Philberta 	F
 Philip 	M
 Philipinna 	F
 Philippe 	M
 Philippine 	F
 Philips 	M
 Phillip 	M
 Phillipa 	F
 Phillipe 	M
 Phillips 	M
 Phillis 	F
 Philomena 	F
 Phineas 	M
 Phoebe 	F
 Phoenix 	M
 Phylicia 	F
 Phylis 	F
 Phyllis 	F
 Pia 	F
 Picaworth 	M
 Picford 	M
 Pickford 	M
 Pickworth 	M
 Pierce 	M
 Piero 	M
 Pierpont 	M
 Pierre 	M
 Pierrel 	M
 Pierrepont 	M
 Pierretta 	F
 Pierrette 	F
 Piers 	M
 Pierson 	M
 Pietra 	F
 Pietro 	M
 Pilar 	F
 Pili 	M
 PiMne 	M
 Ping 	F
 Pink 	M
 Pinkie 	F
 Pinkney 	M
 Pinochos 	M
 Pio 	M
 Piper 	F
 Pipere 	F
 Piperel 	M
 Pippa 	F
 Pippin 	M
 Pippino 	M
 Pirro 	M
 Pitney 	M
 Placida 	F
 Placido 	M
 Plat 	M
 Platon 	M
 Platt 	M
 Pleoh 	M
 Ples 	M
 Polikwaptiwa 	F
 Pollie 	F
 Pollock 	M
 Polly 	F
 Poloma 	F
 Pomeroy 	M
 Pommelraie 	M
 Ponce 	M
 Porfirio 	M
 Porfiro 	M
 Porteur 	M
 Portia 	F
 Portier 	M
 Poul 	M
 Powaqa 	F
 Powell 	M
 Powwaw 	M
 Pranav 	M
 Prasutagus 	M
 Precious 	F
 Prentice 	M
 Prentiss 	M
 Preostcot 	M
 Preruet 	M
 Prescot 	M
 Prescott 	M
 Presley 	F
 Prestin 	M
 Preston 	M
 Prewitt 	M
 Pridwyn 	F
 Priestly 	M
 Primavera 	F
 Primeiro 	M
 Primo 	M
 Princeton 	M
 Priour 	M
 Priscila 	F
 Priscilla 	F
 Prospero 	M
 Prudence 	F
 Prudencia 	F
 Pruet 	M
 Pruie 	M
 Pruitt 	M
 Prunella 	F
 Prunellie 	F
 Pryderi 	M
 Prydwyn 	F
 Pryor 	M
 Pslomydes 	M
 Puebla 	F
 Pueblo 	M
 Pules 	F
 Pura 	F
 Pureza 	F
 Purisima 	F
 Putnam 	M
 Pwyll 	M
 Pyn 	M
 Pyt 	M
 Qadir 	M
 Qaletaqa 	M
 Qaseem 	M
 Qeturah 	F
 Qiana 	F
 Qiao 	F
 Qing Yuan 	F
 Qochata 	M
 Qssim 	M
 Quaid 	M
 Quany 	M
 Quarrie 	M
 Queena 	F
 Queenie 	F
 Quennel 	M
 Quent 	M
 Quentin 	M
 Quenton 	M
 Quentrell 	M
 Queran 	M
 Querida 	F
 Quesnel 	M
 Quiana 	F
 Quigley 	M
 Quin 	M
 Quincey 	M
 Quincy 	M
 Quinevere 	F
 Quinlan 	M
 Quinn 	M
 Quint 	M
 Quinta 	F
 Quinten 	M
 Quintin 	M
 Quinton 	M
 Quintrell 	M
 Raanan 	M
 Raananah 	F
 Rabah 	F
 Rabi 	M
 Rachael 	F
 Racheal 	F
 Rachel 	F
 Rachele 	F
 Rachelle 	F
 Rad 	M
 Radbert 	M
 Radbourne 	M
 Radburn 	M
 Radburt 	M
 Radbyrne 	M
 Radcliff 	M
 Radclyf 	M
 Radeliffe 	M
 Radella 	F
 Radford 	M
 Radhiya 	F
 Radley 	M
 Radmund 	M
 Radnor 	M
 Radolf 	M
 Radolph 	M
 Rae 	F
 Raed 	M
 Raedan 	M
 Raedanoran 	M
 Raedbora 	M
 Raedburne 	M
 Raedclyf 	M
 Raedeman 	M
 Raedford 	M
 Raedleah 	M
 Raedmund 	M
 Raedpath 	M
 Raedself 	F
 Raedwald 	M
 Raedwolf 	M
 Raegan 	F
 Raekwon 	M
 Rafa 	F
 Rafael 	M
 Rafaele 	M
 Rafaello 	M
 Rafal 	M
 Rafe 	M
 Rafela 	F
 Raff 	M
 Rafiki 	M
 Raghnall 	M
 Ragnall 	F
 Ragnar 	M
 Raheem 	M
 Rahi 	F
 Rahil 	F
 Rahimat 	M
 Rahimateh 	F
 Rahsaan 	M
 Rahul 	M
 Rai 	M
 Raicheal 	F
 Ra'id 	M
 Raighne 	M
 Raimond 	M
 Raimondo 	M
 Raimunda 	F
 Raimundo 	M
 Raina 	F
 Rainart 	M
 Rainer 	M
 Rainger 	M
 Rainhard 	M
 Rainier 	M
 Rainor 	M
 Raison 	F
 Raissa 	F
 Raja 	F
 Rakel 	F
 Rakin 	M
 Rald 	M
 Raleah 	M
 Raleich 	M
 Raleigh 	M
 Raley 	M
 Ralf 	M
 Ralph 	M
 Ralston 	M
 Ram 	M
 Rambert 	M
 Ramey 	M
 Ramhart 	M
 Rami 	M
 Ramira 	F
 Ramirez 	M
 Ramiro 	M
 Ramla 	F
 Ramm 	M
 Ramon 	M
 Ramona 	F
 Ramond 	M
 Ramone 	M
 Ramsay 	M
 Ramsden 	M
 Ramsey 	M
 Ramy 	M
 Ramzey 	M
 Ramzi 	M
 Rana 	F
 Ranait 	F
 Ranald 	M
 Ranalt 	F
 Rand 	M
 Randal 	M
 Randale 	M
 Randall 	M
 Randel 	M
 Randell 	M
 Randi 	F
 Randkin 	M
 Randle 	M
 Randolph 	M
 Randon 	M
 Randson 	M
 Randy 	M
 Rane 	M
 Ranell 	M
 Ranen 	M
 Ranfield 	M
 Ranger 	M
 Rangey 	M
 Rangford 	M
 Rangley 	M
 Rangy 	M
 Rani 	M
 Ranica 	F
 Ranice 	F
 Ranier 	M
 Ranit 	M
 Ranita 	F
 Rankin 	M
 Ranon 	M
 Ransom 	M
 Raoghnailt 	F
 Raonaid 	F
 Raoul 	M
 Rapere 	M
 Raphael 	M
 Raphaella 	F
 Raquel 	F
 Rasha 	F
 Rashaad 	M
 Rashad 	M
 Rashawn 	M
 Rasheed 	M
 Rashid 	M
 Rashida 	F
 Rashidi 	M
 Rathnait 	F
 Raul 	M
 Raulo 	M
 Raven 	F
 Ravid 	M
 Ravyn 	F
 Rawgon 	M
 Rawiella 	M
 Rawley 	M
 Rawling 	M
 Rawlins 	M
 Rawls 	M
 Ray M
 Rayburn 	M
 Rayce 	M
 Rayder 	M
 Raydon 	M
 Rayford 	M
 Rayhourne 	M
 Rayhurn 	M
 Raylen 	M
 Rayman 	M
 Raymon 	M
 Raymond 	M
 Raymund 	M
 Raymundo 	M
 Rayna 	F
 Raynard 	M
 Rayne 	M
 Raynell 	M
 Rayner 	M
 Raynor 	M
 Raynord 	M
 Raziya 	F
 Readman 	M
 Reagan 	F
 Reaghan 	M
 Reanna 	F
 Reatha 	F
 Reave 	M
 Reaves 	M
 Reba 	F
 Rebeca 	F
 Rebecca 	F
 Rebekah 	F
 Recene 	M
 Rechavia 	M
 Redamann 	M
 Redd 	M
 Redding 	M
 Redford 	M
 Redley 	M
 Redman 	M
 Redmond 	M
 Redmund 	M
 Redwald 	M
 Reece 	M
 Reed 	M
 Reeford 	M
 Reese 	M
 Reeve 	M
 Reeves 	M
 Refugio 	M
 Regan 	F
 Regenfrithu 	M
 Regenweald 	M
 Reggie 	M
 Reghan 	M
 Regina 	F
 Reginald 	M
 Reginhard 	M
 Reginheraht 	M
 Regis 	M
 Rehema 	F
 Reid 	M
 Reidhachadh 	M
 Reilley 	M
 Reilly 	F
 Reina 	F
 Reinaldo 	M
 Reine 	F
 Reiner 	M
 Reinhard 	M
 Reinhold 	M
 Reino 	M
 Rella 	F
 Remedios 	F
 Remi 	M
 Remington 	M
 Remo 	M
 Remy 	M
 Ren 	M
 Rena 	F
 Renae 	F
 Renaldo 	M
 Renard 	M
 Renata 	F
 Renato 	M
 Rendall 	M
 Rendell 	M
 Rene 	M
 Renea 	F
 Renee 	F
 Renfield 	M
 Renfred 	M
 Renfrid 	M
 Renita 	F
 Renke 	M
 Renne 	M
 Rennie 	M
 Renny 	M
 Reno 	M
 Renshaw 	M
 Renton 	M
 Renweard 	M
 Renzo 	M
 Reod 	M
 Ressie 	F
 Reta 	F
 Retha 	F
 Retta 	F
 Reuben 	M
 Reuhen 	M
 Reule 	M
 Re'uven 	M
 Reva 	F
 Reve 	M
 Reveka 	F
 Rex 	M
 Rexford 	M
 Rexley 	M
 Rexlord 	M
 Rexton 	M
 Rey 	M
 Reyes 	M
 Reyhurn 	M
 Reymond 	M
 Reymundo 	M
 Reyna 	F
 Reynald 	M
 Reynaldo 	M
 Reynard 	M
 Reynardo 	M
 Reynold 	M
 Reynolds 	M
 Rhaxma 	F
 Rhea 	F
 Rheda 	F
 Rheged 	M
 Rhett 	M
 Rhiannon 	F
 Rhoda 	F
 Rhodes 	M
 Rhonda 	F
 Ria 	F
 Riagan 	M
 Rian 	M
 Rica 	F
 Ricadene 	M
 Ricard 	M
 Ricarda 	F
 Ricardo 	M
 Riccardo 	M
 Richael 	F
 Richard 	M
 Richardo 	M
 Richelle 	F
 Richie 	M
 Richman 	M
 Richmond 	M
 Rick 	M
 Rickard 	M
 Ricker 	M
 Rickey 	M
 Ricki 	M
 Rickie 	M
 Rickman 	M
 Rickward 	M
 Ricky 	M
 Ricman 	M
 Rico 	M
 Ricweard 	M
 Riddoc 	M
 Riddock 	M
 Rider 	M
 Ridere 	M
 Ridge 	M
 Ridgeiey 	M
 Ridgely 	M
 Ridley 	M
 Ridpath 	M
 Rigby 	M
 Rigel 	M
 Rigg 	M
 Riggs 	M
 Rigoberto 	M
 Rikard 	M
 Rikkard 	M
 Rikki 	F
 Rikward 	M
 Riley 	M
 Rilla 	F
 Rille 	F
 Rilletta 	F
 Rillette 	F
 Rillia 	F
 Rillie 	F
 Rima 	F
 Rimona 	F
 Rina 	F
 Rinaldo 	M
 Rinan 	M
 Rinc 	M
 Rinna 	F
 Rinnah 	F
 Rio 	M
 Riobard 	M
 Riocard 	M
 Rioghnach 	F
 Rion 	M
 Riona 	F
 Riordain 	M
 Riordan 	M
 Ripley 	M
 Rique 	M
 Risley 	M
 Risteard 	M
 Riston 	M
 Rita 	F
 Ritchie 	M
 Ritter 	M
 Riva 	F
 Rivalen 	M
 Rive 	F
 Rivka 	F
 Riyad 	M
 Roald 	M
 Roan 	M
 Roana 	F
 Roane 	M
 Roano 	M
 Roark 	M
 Robb 	M
 Robbie 	F
 Robbin 	F
 Robby 	M
 Robena 	F
 Robert 	M
 Roberta 	F
 Robertia 	F
 Roberto 	M
 Robertson 	M
 Robina 	F
 Robinetta 	F
 Robinette 	F
 Roble 	M
 Robyn 	F
 Rocco 	M
 Rochelle 	F
 Rocio 	F
 Rockford 	M
 Rockland 	M
 Rockwell 	M
 Rodd 	M
 Roddric 	M
 Roddrick 	M
 Roddy 	M
 Rodell 	M
 Roderic 	M
 Roderica 	F
 Roderick 	M
 Roderiga 	F
 Roderigo 	M
 Roderik 	M
 Roderika 	F
 Rodes 	M
 Rodger 	M
 Rodman 	M
 Rodney 	M
 Rodolfo 	M
 Rodric 	M
 Rodrick 	M
 Rodrigo 	M
 Rodrik 	M
 Rodwell 	M
 Roe 	M
 Roel 	M
 Roesia 	F
 Rogan 	M
 Rogelio 	M
 Roger 	M
 Rogers 	M
 Rohais 	F
 Rohan 	M
 Roi 	M
 Roial 	F
 Roibeard 	M
 Roibin 	M
 Rois 	F
 Roland 	M
 Rolanda 	F
 Rolande 	F
 Rolando 	M
 Roldan 	M
 Roldana 	F
 Rolf 	M
 Rolfe 	M
 Rolla 	M
 Rollan 	M
 Rolland 	M
 Rollie 	M
 Rollin 	M
 Rollo 	M
 Roma 	F
 Romain 	M
 Romaine 	F
 Roman 	M
 Romana 	F
 Romano 	M
 Romeo 	M
 Romhild 	F
 Romhilda 	F
 Romhilde 	F
 Romia 	F
 Romie 	M
 Romilda 	F
 Romilde 	F
 Romney 	M
 Romona 	F
 Ron 	M
 Rona 	F
 Ronal 	M
 Ronald 	M
 Ronaldo 	M
 Ronan 	M
 Ronat 	F
 Ronda 	F
 Ronell 	M
 Rong 	F
 Roni 	M
 Ronia 	F
 Ronit 	M
 Ronli 	F
 Ronn 	M
 Ronna 	F
 Ronnell 	M
 Ronnie 	M
 Ronny 	M
 Ronson 	M
 Rooney 	M
 Roosevelt 	M
 Roper 	M
 Roque 	M
 Rorey 	M
 Rorke 	M
 Rorry 	M
 Rory 	M
 Ros 	M
 Rosa 	F
 Rosalee 	F
 Rosalia 	F
 Rosalie 	F
 Rosalind 	F
 Rosalinda 	F
 Rosalinde 	F
 Rosaline 	F
 Rosalyn 	F
 Rosamaria 	F
 Rosamond 	F
 Rosamonde 	F
 Rosamund 	F
 Rosana 	F
 Rosann 	F
 Rosanna 	F
 Rosanne 	F
 Rosario 	F
 Rosco 	M
 Roscoe 	M
 Roseann 	F
 Roseanna 	F
 Roseanne 	F
 Roselani 	F
 Roselin 	M
 Rosella 	F
 Roselyn 	F
 Rosemaria 	F
 Rosemarie 	F
 Rosemary 	F
 Rosemonde 	F
 Rosemunda 	F
 Rosetta 	F
 Rosevelt 	M
 Rosia 	F
 Rosie 	F
 Rosina 	F
 Rosita 	F
 RosIyn 	M
 Roslin 	M
 Roslyn 	F
 Ross 	M
 Rosselin 	M
 Rosselyn 	M
 Rossie 	F
 Rossiter 	M
 Rosston 	M
 Rosswald 	M
 Roswald 	M
 Roswalt 	M
 Roswell 	M
 Rosy 	F
 Roth 	M
 Rourke 	M
 Rousse 	M
 Roussel 	M
 Rousset 	M
 Rousskin 	M
 Rouvin 	M
 Roux 	F
 Rover 	M
 Rovere 	M
 Rowan 	M
 Rowdy 	M
 Rowe 	M
 Rowell 	M
 Rowen 	M
 Rowena 	F
 Roweson 	M
 Rowin 	M
 Rowland 	M
 Rowley 	M
 Rowson 	M
 Rowtag 	M
 Rowyn 	M
 Roxana 	F
 Roxane 	F
 Roxann 	F
 Roxanna 	F
 Roxanne 	F
 Roxbury 	M
 Roxie 	F
 Roxy 	F
 Roy 	M
 Royall 	M
 Royan 	M
 Royce 	M
 Royden 	M
 Royns 	M
 Royse 	M
 Rozamond 	F
 Rozella 	F
 Rozene 	F
 Rozmonda 	F
 Rozomund 	F
 R'phael 	M
 Ruadhagan 	M
 Ruadhan 	M
 Ruadson 	M
 Ruaidhri 	M
 Ruanaidh 	M
 Ruarc 	M
 Ruark 	M
 Rube 	M
 Ruben 	M
 Rubie 	F
 Rubin 	M
 Ruby 	F
 Rubye 	F
 Ruck 	M
 Rudd 	M
 Ruddy 	M
 Rudella 	F
 Rudelle 	F
 Rudiger 	M
 Rudolf 	M
 Rudolph 	M
 Rudy 	M
 Rudyard 	M
 Rueban 	M
 Rueben 	M
 Ruel 	M
 Ruelle 	M
 Rufa 	F
 Ruff 	M
 Ruffe 	M
 Rufford 	M
 Rufina 	F
 Rufio 	M
 Rufo 	M
 Ruford 	M
 Rufus 	M
 Ruggero 	M
 Ruhdugeard 	M
 Ruhleah 	M
 Rui 	M
 Rumord 	M
 Ruodrik 	M
 Ruomhildi 	F
 Rupert 	M
 Rupetta 	F
 Rupette 	F
 Ruprecht 	M
 Rushe 	M
 Rushford 	M
 Rushkin 	M
 Russ 	M
 Russel 	M
 Russell 	M
 Ruta 	F
 Rutger 	M
 Ruth 	F
 Rutha 	F
 Ruthann 	F
 Ruthe 	F
 Rutherford 	M
 Ruthie 	F
 Rutledge 	M
 Rutley 	M
 Ryan 	M
 Ryann 	F
 Ryce 	M
 Rycroft 	M
 Ryder 	M
 Rydge 	M
 Ryen 	M
 Ryence 	M
 Rygecroft 	M
 Rygeland 	M
 Rygemann 	M
 Rylan 	M
 Ryland 	M
 Rylee 	F
 Ryleigh 	F
 Ryley 	M
 Rylie 	F
 Ryman 	M
 Ryne 	M
 Ryon 	M
 Ryons 	M
 Rypan 	M
 Rysc 	M
 Ryscford 	M
 Ryszard 	M
 Ryton 	M
 Saada 	F
 Saadya 	M
 Sabana 	F
 Sabastian 	M
 Sabih 	M
 Sabina 	F
 Sabino 	M
 Sabir 	M
 Sabirah 	F
 Sabra 	F
 Sabrina 	F
 Sada 	F
 Sadaka 	M
 Sadbh 	F
 Sade 	F
 Sadhbba 	F
 Sadhbh 	F
 Sadie 	F
 Sadio 	F
 Sadiq 	M
 Sadira 	F
 Sadye 	F
 Saebeorht 	M
 Saeger 	M
 Saelac 	M
 Saelig 	M
 Saewald 	M
 Saeweard 	M
 Safa 	F
 Saffi 	F
 Safford 	M
 Safia 	F
 Safiwah 	F
 Sagar 	M
 Sage 	F
 Saghir 	M
 Sagirah 	F
 Sagramour 	M
 Sagremor 	M
 Sahale 	M
 Sahar 	F
 Sahir 	M
 Saida 	F
 Saidah 	F
 Saige 	F
 Sakeri 	M
 Sakima 	M
 Sal 	M
 Salali 	F
 Salamon 	M
 Salbatora 	F
 Salbatore 	M
 Saleem 	M
 Salem 	M
 Salford 	M
 Salhdene 	M
 Salhford 	M
 Salhtun 	M
 Salim 	M
 Salina 	F
 Sallie 	F
 Sallsbury 	M
 Sally 	F
 Salma 	F
 Saloma 	F
 Salome 	F
 Salomeaexl 	F
 Salomon 	M
 Salton 	M
 Salvador 	M
 Salvadora 	F
 Salvadore 	M
 Salvatora 	F
 Salvatore 	M
 Salvatorio 	M
 Salvino 	M
 Sam 	M
 Samantha 	F
 Samar 	F
 Samara 	F
 Sameh 	F
 Sami 	M
 Samir 	M
 Samira 	F
 Samirah 	F
 Samman 	M
 Sammie 	M
 Sammy 	M
 Samoel 	M
 Sampson 	M
 Samson 	M
 Samual 	M
 Samuel 	M
 Samuela 	F
 Sanborn 	M
 Sanbourne 	M
 Sancha 	F
 Sancho 	M
 Sancia 	F
 Sanders 	M
 Sanderson 	M
 Sandi 	F
 Sandon 	M
 Sandra 	F
 Sanersone 	M
 Sanford 	M
 Sani 	M
 Sanson 	M
 Santa 	F
 Santana 	F
 Santiago 	M
 Santina 	F
 Santino 	M
 Santo 	M
 Santon 	M
 Santos 	M
 Sanura 	F
 Sapphira 	F
 Sapphire 	F
 Saqr 	M
 Sar 	M
 Sara 	F
 Sarah 	F
 Sarahi 	F
 Sarai 	F
 Saraid 	F
 Sargent 	M
 Sarina 	F
 Sarita 	F
 Sarlic 	M
 Sarohildi 	F
 Sarrah 	F
 Sarsour 	M
 Sarsoureh 	F
 Sasha 	F
 Sasson 	M
 Sativola 	M
 Satordi 	M
 Saturnin 	M
 Saturnina 	F
 Sauda 	F
 Saul 	M
 Saunders 	M
 Saunderson 	M
 Saundra 	F
 Sauville 	M
 Savana 	F
 Savanah 	F
 Savanna 	F
 Savannah 	F
 Saveage 	F
 Saville 	M
 Savion 	M
 Sawyer 	M
 Sawyere 	M
 Sawyers 	M
 Saxan 	M
 Saxon 	M
 Saxona 	F
 Saxonia 	F
 Saxons 	F
 Sayyid 	M
 SBtinka 	F
 Scadwiella 	M
 Scaffeld 	M
 Scand 	M
 Scandleah 	M
 Scandy 	M
 Scanlan 	M
 Scanlon 	M
 Scannalan 	M
 Scarlet 	F
 Scarlett 	F
 Scead 	M
 Sceadu 	M
 Sceapleigh 	M
 Sceley 	M
 Scelflesh 	F
 Scelftun 	M
 Sceotend 	M
 Schaddoc 	M
 Schaeffer 	M
 Schaffer 	M
 Schlomit 	F
 Schmaiah 	M
 Schmuel 	M
 Schuyler 	M
 Schyler 	F
 SciIti 	M
 Scirloc 	M
 Scirwode 	M
 ScIymgeour 	M
 Scolaighe 	M
 Scot 	M
 Scota 	F
 Scott 	M
 Scottas 	M
 Scottie 	M
 Scotty 	M
 Scowyrhta 	M
 Scrydan 	M
 Scully 	M
 Scur 	M
 Seabert 	M
 Seabright 	M
 Seabroc 	M
 Seabrook 	M
 Seaburt 	M
 Seadon 	M
 Seafra 	M
 Seafraid 	M
 Seager 	M
 Seaghda 	M
 Sealey 	M
 Seamere 	M
 Seamus 	M
 Sean 	M
 Seana 	F
 Seanachan 	M
 Seanan 	M
 Seanlaoch 	M
 Searbhreathach 	M
 Searlait 	F
 Searlas 	M
 Searle 	M
 Searlus 	M
 Seaton 	M
 Seaver 	M
 Seaward 	M
 Sebastian 	M
 Sebastiana 	F
 Sebastiano 	M
 Sebastien 	M
 Sebert 	M
 Sebille 	F
 Secg 	M
 Secgwic 	M
 Sedge 	M
 Sedgeley 	M
 Sedgewic 	M
 Sedgewick 	M
 Sedgewik 	M
 Sedrick 	M
 Seely 	M
 Seeton 	M
 Sefton 	M
 Sefu 	M
 Segar 	M
 Segenam 	M
 Seger 	M
 Segulah 	F
 Segunda 	F
 Segundo 	M
 Seignour 	M
 Sein 	M
 Seina 	F
 Seireadan 	M
 Sekai 	F
 Sela 	F
 Selby 	M
 Selden 	M
 Seldon 	M
 Sele 	F
 Seleby 	M
 Selena 	F
 Seleta 	F
 Selig 	M
 Selik 	M
 Selima 	F
 Selina 	F
 Selma 	F
 Selmer 	M
 Selvyn 	M
 Selwin 	M
 Selwine 	M
 Selwyn 	M
 Semadar 	F
 Semaj 	M
 Semira 	F
 Sena 	F
 Senalda 	F
 Seneca 	M
 Senen 	M
 Sener 	M
 Senet 	M
 Sennet 	M
 Senon 	M
 Senona 	F
 Senta 	F
 Sente 	F
 Seosaimhin 	F
 Seosaimhthin 	F
 Seosamh 	M
 Seosaph 	M
 Serafim 	M
 Serafin 	M
 Serafina 	F
 Serafine 	F
 Seraphim 	M
 Seraphina 	F
 Seraphine 	F
 Serefina 	F
 Serena 	F
 Serenity 	F
 Sergio 	M
 Serhild 	F
 Serhilda 	F
 Serihilda 	F
 Serihilde 	F
 Serilda 	F
 Setanta 	M
 Seth 	M
 Seton 	M
 Severin 	M
 Severn 	M
 Severne 	M
 Severo 	M
 Sevrin 	M
 Sewald 	M
 Sewall 	M
 Seward 	M
 Sewati 	M
 Sewell 	M
 Seymour 	M
 Shaan 	M
 Shad 	M
 Shada 	F
 Shadd 	M
 Shaddoc 	M
 Shaddock 	M
 Shadoe 	M
 Shadrach 	M
 Shadwell 	M
 Shae 	M
 Shai 	M
 Shaiming 	M
 Shain 	M
 Shaina 	F
 Shakira 	F
 Shaku 	M
 Shalom 	M
 Shalonda 	F
 Shalott 	F
 Shamar 	M
 Shameka 	F
 Shamika 	F
 Shamus 	M
 Shan 	M
 Shana 	F
 Shanahan 	M
 Shanda 	F
 Shandley 	M
 Shandon 	M
 Shandy 	M
 Shane 	M
 Shani 	F
 Shania 	F
 Shanice 	F
 Shanika 	F
 Shaniqua 	F
 Shanita 	F
 Shaniya 	F
 Shanley 	M
 Shann 	M
 Shanna 	F
 Shannan 	F
 Shannon 	F
 Shanon 	F
 Shanta 	F
 Shante 	F
 Shantel 	F
 Shantell 	F
 Shaquan 	M
 Shaquille 	M
 Shara 	F
 Shareef 	M
 Sharen 	F
 Shari 	F
 Sharif 	M
 Sharifah 	F
 Sharla 	F
 Sharlene 	F
 Sharon 	F
 Sharonda 	F
 Sharron 	F
 Sharufa 	F
 Sharyn 	F
 Shasta 	F
 Shattuck 	M
 Shauden 	M
 Shaughn 	M
 Shaun 	M
 Shauna 	F
 Shaundre 	M
 Shavon 	F
 Shaw 	M
 Shawanda 	F
 Shawe 	M
 Shawn 	M
 Shawna 	F
 Shawnn 	M
 Shay 	M
 Shayan 	M
 Shaye 	M
 Shayla 	F
 Shaylee 	F
 Shaylon 	M
 Shayna 	F
 Shayne 	M
 Shea 	F
 Sheary 	M
 Sheedy 	M
 Sheehan 	M
 Sheelah 	F
 Sheena 	F
 Sheffield 	M
 Sheila 	F
 Sheiling 	M
 Sheiramoth 	F
 Shelba 	F
 Shelbi 	F
 Shelbie 	F
 Shelby 	F
 Shelden 	M
 Sheldon 	M
 Shelia 	F
 Shelley 	F
 Shelli 	F
 Shellie 	F
 Shelly 	F
 Shelny 	M
 Shelomo 	M
 Shelton 	M
 Shelva 	F
 Shem 	M
 Shemar 	M
 Shemariah 	F
 Shemus 	M
 Shen 	M
 Shepley 	M
 Sheply 	M
 Sherard 	M
 Sherborne 	M
 Sherbourn 	M
 Sherbourne 	M
 Sherburne 	M
 Sheree 	F
 Shereef 	M
 Sheri 	F
 Sheridan 	F
 Sherie 	F
 Sherif 	M
 Sherilyn 	F
 Sherita 	F
 Sherlock 	M
 Sherlyn 	F
 Sherman 	M
 Shermarke 	M
 Shermon 	M
 Sheron 	F
 Sherri 	F
 Sherrie 	F
 Sherrill 	F
 Sherron 	F
 Sherry 	F
 Sherryl 	F
 Sherwin 	M
 Sherwood 	M
 Sherwyn 	M
 Sheryl 	F
 Sheshebens 	F
 Shet 	M
 Shey 	M
 Shiela 	F
 Shifra 	F
 Shilah 	M
 Shilo 	M
 Shiloh 	M
 Shim'on 	M
 Shimshon 	M
 Shing 	M
 Shipley 	M
 Shipton 	M
 Shira 	F
 Shiri 	F
 Shiriki 	M
 Shirlee 	F
 Shirlene 	F
 Shirley 	F
 Shiye 	M
 Shizhe'e 	M
 Shoemowetochawcawe 	M
 Shon 	M
 Shonda 	F
 Shonn 	M
 Shonna 	F
 Shoshana 	F
 Shreya 	F
 Shu Fang 	F
 Shuang 	F
 Shulamit 	F
 Shuman 	F
 Shunnar 	M
 Shunnareh 	F
 Shyann 	F
 Shyanne 	F
 Siany 	F
 Sibeal 	F
 Sibley 	F
 Sibyl 	F
 Sibyla 	F
 Sicheii 	M
 Sid 	M
 Siddael 	M
 Siddell 	M
 Sidell 	M
 Sidney 	M
 Sidonia 	F
 Sidonie 	F
 Sidwell 	M
 Siegfried 	M
 Sierra 	F
 Sigehere 	M
 Sigenert 	M
 Sigfreda 	F
 Sigfrid 	M
 Sigfrieda 	F
 Sigfriede 	F
 Sigifrid 	M
 Sigifrith 	M
 Sigilwig 	F
 Sigiwald 	M
 Sigmund 	M
 Signe 	F
 Sigrid 	F
 Sigune 	F
 Sigwald 	M
 Sigwalt 	M
 Sihtric 	M
 Sihu 	F
 Sike 	M
 Sik'is 	M
 Sikyahonaw 	M
 Sikyatavo 	M
 Silana 	F
 Silas 	M
 Sile 	F
 Sileas 	F
 Silsby 	M
 Silverio 	M
 Silvester 	M
 Silvestre 	M
 Silvia 	F
 Silvino 	M
 Silvio 	M
 Sim 	M
 Sima 	F
 Simao 	M
 Simba 	M
 Simcha 	M
 Simen 	M
 Simeon 	M
 Simon 	M
 Simona 	F
 Simone 	F
 Simpson 	M
 Simson 	M
 Sina 	F
 Sinai 	M
 Sinclair 	M
 Sinclaire 	M
 Sine 	F
 Sinead 	F
 Sineidin 	F
 Sinjin 	M
 Sinley 	M
 Sinon 	M
 Sinopa 	F
 Siobhan 	F
 Siodhachan 	M
 Siomon 	M
 Sippora 	F
 Sisika 	F
 Siti 	F
 Siubhan 	F
 Siusan 	F
 Sive 	F
 Siwili 	M
 Skah 	M
 Skeat 	M
 Skeet 	M
 Skelton 	M
 Skena 	F
 Skene 	M
 Skete 	M
 Sketes 	M
 Skippere 	M
 Skipton 	M
 Skye 	F
 Skyelar 	M
 Skyla 	F
 Skylar 	F
 Skyler 	M
 Skylor 	M
 Slade 	M
 Slaed 	M
 Slaine 	F
 Slainie 	F
 Slania 	F
 Slanie 	F
 Slany 	F
 Slaton 	M
 Slayton 	M
 Slean 	M
 Slecg 	M
 Sloan 	M
 Sloane 	M
 Smedley 	M
 Smedt 	M
 Smetheleah 	M
 Smith 	M
 Smyth 	M
 Smythe 	M
 Snell 	M
 Snowden 	M
 Socorro 	F
 Sofia 	F
 Sofie 	F
 Sokanon 	F
 Sokw 	F
 Sol 	M
 Solaina 	F
 Solaine 	F
 Solana 	F
 Solange 	F
 Soledad 	F
 Soledada 	F
 Soloman 	M
 Solomon 	M
 Solon 	M
 Solvig 	F
 Somer 	M
 Somerset 	M
 Somerton 	M
 Somerville 	M
 Sommer 	F
 Son 	M
 Sondra 	F
 Songaa 	M
 Sonia 	F
 Sonja 	F
 Sonnie 	M
 Sonny 	M
 Sonya 	F
 Sooleawa 	F
 Sophia 	F
 Sophie 	F
 Sophronia 	F
 Sorcha 	F
 Soredamors 	F
 Sorel 	M
 Soren 	M
 Sorina 	F
 Sorley 	M
 Sorrell 	M
 Sosanna 	F
 Southwell 	M
 Sowi'ngwa 	M
 Soyala 	F
 Spalding 	M
 Spangler 	M
 Spark 	M
 Sparke 	M
 Spelding 	M
 Spence 	M
 Spencer 	M
 Spengler 	M
 Spenser 	M
 Speranza 	F
 Spere 	M
 Sproul 	M
 Sproule 	M
 Sprowle 	M
 Spurgeon 	M
 Squier 	M
 Sroda 	F
 Sruthair 	M
 Sruthan 	M
 St. Alban 	M
 Stacey 	F
 Staci 	F
 Stacia 	F
 Stacie 	F
 Stacy 	F
 Staerling 	M
 Stafford 	M
 Stamord 	M
 Stan 	M
 Stanbeny 	M
 Stanburh 	M
 Stanbury 	M
 StancIyf 	M
 Stancliff 	M
 Standish 	M
 Stanedisc 	M
 Stanfeld 	M
 Stanfield 	M
 Stanford 	M
 Stanhop 	M
 Stanhope 	M
 Stanley 	M
 Stanly 	M
 Stanton 	M
 Stantun 	M
 Stanway 	M
 Stanweg 	M
 Stanwic 	M
 Stanwick 	M
 Stanwik 	M
 Stanwode 	M
 Stanwood 	M
 Stanwyk 	M
 Starbuck 	M
 Starla 	F
 Starling 	M
 Starls 	F
 Starr 	F
 Stasia 	F
 Staunton 	M
 Steadman 	M
 Stearc 	M
 Stearn 	M
 Steathford 	M
 Stedeman 	M
 Stedman 	M
 Steele 	M
 Stefan 	M
 Stefani 	F
 Stefania 	F
 Stefanie 	F
 Stefano 	M
 Stefford 	M
 Stefn 	M
 Stefon 	M
 Stein 	M
 Steiner 	M
 Stella 	F
 Stepan 	M
 Stephan 	M
 Stephania 	F
 Stephanie 	F
 Stephany 	F
 Stephen 	M
 Stephenie 	F
 Stephenson 	M
 Stephon 	M
 Sterling 	M
 Sterlyn 	M
 Sterne 	M
 Stevan 	M
 Steve 	M
 Steven 	M
 Stevenson 	M
 Stevie 	M
 Stevon 	M
 Stevyn 	M
 Stewart 	M
 Stewert 	M
 Stigols 	M
 Stiles 	M
 Stille 	M
 Stilleman 	M
 Stillman 	M
 Stillmann 	M
 Stilwell 	M
 Stina 	F
 Stirling 	M
 Stoc 	M
 Stockard 	F
 Stockhard 	F
 Stockhart 	F
 Stockley 	M
 Stockwell 	M
 Stocleah 	M
 Stocwiella 	M
 Stod 	M
 Stodd 	M
 Stoddard 	M
 Stok 	M
 Stokkard 	F
 Storme 	M
 Stormie 	F
 Stowe 	M
 Strahan 	M
 Strang 	M
 Stratford 	M
 Strod 	M
 Stroud 	M
 Struan 	M
 Struana 	F
 Struthers 	M
 Stuart 	M
 Sucki 	M
 Sudi 	M
 Sudie 	F
 Sue 	F
 Sueanne 	F
 Suelita 	F
 Suellen 	F
 Suffield 	M
 Sugn 	M
 Suidhne 	M
 Suileabhan 	M
 Sula 	F
 Sulaiman 	M
 Sule 	M
 SulliMn 	M
 Sullivan 	M
 Sully 	M
 Suma 	F
 Sumarville 	M
 Sumernor 	M
 Sumerton 	M
 Sumertun 	M
 Sumner 	M
 Sundiata 	M
 Sunki 	F
 Sunn 	F
 Sunniva 	F
 Sunukkuhkau 	M
 Susan 	F
 Susana 	F
 Susann 	F
 Susanna 	F
 Susannah 	F
 Susanne 	F
 Susie 	F
 Susy 	F
 SutcIyf 	M
 Sutcliff 	M
 Suthclif 	M
 Sutherland 	M
 Suthfeld 	M
 Suthleah 	M
 Suthley 	M
 Suttecliff 	M
 Sutton 	M
 Suzan 	F
 Suzann 	F
 Suzanna 	F
 Suzannah 	F
 Suzanne 	F
 Suzetta 	F
 Suzette 	F
 Suzy 	F
 Svend 	M
 Swain 	M
 Swayn 	M
 Sweeney 	M
 Swinton 	M
 Swintun 	M
 Swithun 	M
 Sybil 	F
 Syble 	F
 Sybylla 	F
 Syd 	M
 Sydnee 	F
 Sydney 	F
 Sydni 	F
 Sydnie 	F
 Syed 	M
 Sying 	M
 Sylvan 	M
 Sylvana 	F
 Sylvester 	M
 Sylvia 	F
 Sylvie 	F
 Sylvina 	F
 Sylvonna 	F
 Symeon 	M
 Symington 	M
 Symon 	M
 Symontun 	M
 Synn 	M
 Synne 	F
 Synnove 	F
 Taaveti 	M
 Taavi 	M
 Tabatha 	F
 Tabbart 	M
 Taber 	M
 Tabia 	F
 Tabitha 	F
 Tablita 	F
 Tabor 	M
 Tabora 	F
 Tacy 	F
 Tad 	M
 Tadd 	M
 Tadeo 	M
 Tadhg 	M
 Tadleigh 	M
 Taft 	M
 Tage 	M
 Tahbert 	M
 Tahirah 	F
 Tahkeome 	M
 Tahki 	F
 Tahlia 	F
 Tahmelapachme 	M
 Tahu 	M
 Tahurer 	M
 Taicligh 	M
 Taillefer 	M
 Taima 	M
 Tait 	M
 Taite 	F
 Taj 	M
 Tajo 	M
 Takala 	F
 Takisha 	F
 Takoda 	M
 Tal 	M
 Tala 	F
 Talbert 	M
 Talbot 	M
 Talbott 	M
 Talehot 	M
 Talford 	M
 Talia 	F
 Taliah 	F
 Taliesin 	M
 Talihah 	F
 Talitha 	F
 Taliyah 	F
 Tallis 	F
 Tallon 	M
 Talmadge 	M
 Talmage 	M
 Talora 	F
 Talori 	F
 Talulah 	F
 Talya 	F
 Tama 	F
 Tamala 	F
 Tamar 	M
 Tamara 	F
 Tamarah 	F
 Tamas 	M
 Tamatha 	F
 Tameka 	F
 Tamela 	F
 Tamera 	F
 Tami 	F
 Tamia 	F
 Tamica 	F
 Tamie 	F
 Tamika 	F
 Tamiko 	F
 Tamir 	M
 Tamma 	F
 Tammi 	F
 Tammie 	F
 Tammy 	F
 Tamnais 	M
 Tamra 	F
 Tamryn 	F
 Tamsin 	F
 Tamtun 	M
 Tana 	F
 Taneli 	M
 Tanesha 	F
 Tangakwunu 	M
 Tangela 	F
 Tangerina 	F
 Tangerine 	F
 Tanguy 	M
 Tania 	F
 Tanika 	F
 Tanis 	F
 Tanisha 	F
 Taniya 	F
 Tanner 	M
 Tannere 	M
 Tansy 	F
 Tanton 	M
 Tanya 	F
 Tao 	F
 Tapani 	M
 Tara 	F
 Tarafah 	M
 Tarah 	F
 Taralynn 	F
 Tarana 	F
 Tarek 	M
 Tareq 	M
 Tarick 	M
 Tarif 	M
 Tarik 	M
 Tarin 	F
 Tariq 	M
 Tarique 	M
 Tarleton 	M
 Taron 	M
 Tarrah 	F
 Tarrence 	M
 Tarrin 	M
 Tarsha 	F
 Taruh 	F
 Taryn 	F
 Tarynn 	F
 Tasha 	F
 Tashia 	F
 Tassa 	M
 Tasunke 	M
 Tatanka ptecila 	M
 Tate 	M
 Tatiana 	F
 Tatianna 	F
 Tatu 	F
 Tatum 	F
 Tatyana 	F
 Taura 	F
 Taurean 	M
 Taurina 	F
 Taurino 	M
 Tauro 	M
 Taurus 	M
 Tavares 	M
 Taveon 	M
 Tavey 	M
 Tavia 	F
 Tavin 	M
 Tavio 	M
 Tavion 	M
 Tavis 	M
 Tavish 	M
 Tavon 	M
 Tawana 	F
 Tawanda 	F
 Tawanna 	F
 Taweel 	M
 Tawnee 	F
 Tawney 	F
 Tawni 	F
 Tawnia 	F
 Tawnie 	F
 Tawny 	F
 Tawnya 	F
 Taya 	F
 Tayanita 	F
 Taylan 	M
 Tayler 	F
 Taylon 	M
 Taylor 	F
 Taysir 	M
 Tayson 	M
 Tayt 	M
 Tayte 	M
 Teagan 	F
 Teaghue 	M
 Teague 	M
 Teamhair 	F
 Tearlach 	M
 Tearle 	M
 Ted 	M
 Tedd 	M
 Teddi 	F
 Teddie 	M
 Teddy 	M
 Tedman 	M
 Tedmond 	M
 Tedmund 	M
 Tedric 	M
 Tedrick 	M
 Teela 	F
 Teena 	F
 Teetonka 	M
 Tegan 	F
 Tehya 	F
 Teige 	F
 Teithi 	M
 Telfer 	M
 Telfor 	M
 Telford 	M
 Telfour 	M
 Tellan 	M
 Telly 	M
 Telma 	F
 Telutci 	M
 Teme 	F
 Temima 	F
 Temira 	F
 Temman 	M
 Tempeltun 	M
 Tempeste 	F
 Tempie 	F
 Temple 	M
 Templeton 	M
 Tena 	F
 Tenisha 	F
 Tennessee 	F
 Tennie 	F
 Tennille 	F
 Tennyson 	M
 Tentagil 	M
 Teo 	M
 Teodor 	M
 Teodora 	F
 Teodoro 	M
 Teon 	M
 Teppo 	M
 Ter Heide 	M
 Tera 	F
 Terceira 	F
 Terciero 	M
 Terell 	M
 Terence 	M
 Teresa 	F
 Terese 	F
 Teresita 	F
 Teressa 	F
 Teri 	F
 Teriana 	F
 Teriann 	F
 Terika 	M
 Terilynn 	F
 Teris 	M
 Terra 	F
 Terrall 	M
 Terran 	M
 Terrance 	M
 Terrel 	M
 Terrell 	M
 Terrelle 	M
 Terrence 	M
 Terri 	F
 Terrie 	F
 Terrill 	M
 Terrin 	M
 Terris 	M
 Terriss 	M
 Terron 	M
 Terry 	M
 Terryn 	F
 Terrys 	M
 Teryn 	F
 Teryysone 	M
 Terza 	F
 Tess 	F
 Tessa 	F
 Tessia 	F
 Tessie 	F
 Teva 	F
 Tevin 	M
 Tevis 	M
 Tewodros 	M
 Tex 	M
 Teyen 	M
 Teyo 	M
 Teyrnon 	M
 Thacher 	M
 Thacker 	M
 Thackere 	M
 Thad 	M
 Thaddeus 	M
 Thadina 	F
 Thadine 	F
 Thain 	M
 Thalia 	F
 Thane 	M
 Thatcher 	M
 Thawain 	M
 Thaxter 	M
 Thayne 	M
 Thea 	F
 Theadore 	M
 Thearl 	M
 Theda 	F
 Thekla 	F
 Thelma 	F
 Theo 	M
 Theodora 	F
 Theodore 	M
 Theodorus 	M
 Theodosia 	F
 Theola 	F
 Theomund 	M
 Theon 	M
 Theresa 	F
 Therese 	F
 Theresia 	F
 Theron 	M
 Therron 	M
 Theyn 	M
 Thibaud 	M
 Thieny 	M
 Thierry 	M
 Thirza 	F
 Thom 	M
 Thoma 	M
 Thomas 	M
 Thomasin 	F
 Thomdic 	M
 Thomkins 	M
 Thompson 	M
 Thomsina 	F
 Thor 	M
 Thora 	F
 Thoraldtun 	M
 Thorley 	M
 Thormond 	M
 Thormund 	M
 Thorn 	M
 Thorndike 	M
 Thorndyke 	M
 Thorne 	M
 Thornley 	M
 Thornly 	M
 Thornton 	M
 Thorntun 	M
 Thorp 	M
 Thorpe 	M
 Thos 	M
 Thrythwig 	M
 Thunder 	M
 Thurhloew 	M
 Thurl 	M
 Thurle 	M
 Thurleah 	M
 Thurleigh 	M
 Thurlow 	M
 Thurman 	M
 Thurmond 	M
 Thurstan 	M
 Thurston 	M
 Thurstun 	M
 Thwayya 	F
 Tia 	F
 Tiahna 	F
 Tiana 	F
 Tiane 	F
 Tianna 	F
 Tiara 	F
 Tiarchnach 	M
 Tiauna 	F
 Tibault 	M
 Tibbot 	M
 Tibelda 	F
 Tibelde 	F
 Tibeldie 	F
 Tiberia 	F
 Tiberio 	M
 Tiebout 	M
 Tier 	M
 Tiera 	F
 Tiernan 	M
 Tiernay 	M
 Tierney 	M
 Tierra 	F
 Tiesha 	F
 Tiffani 	F
 Tiffanie 	F
 Tiffany 	F
 Tiffney 	M
 Tighe 	M
 Tighearnach 	M
 Tihalt 	M
 Tihkoosue 	M
 T'iis 	M
 Tikva 	F
 Tila 	M
 Tiladene 	M
 Tilda 	F
 Tilden 	M
 Tilford 	M
 Tilian 	M
 Tillie 	F
 Tillman 	M
 Tilly 	F
 Tilman 	M
 Tilton 	M
 Tim 	M
 Timmie 	M
 Timmothy 	M
 Timmy 	M
 Timo 	M
 Timon 	M
 Timoteo 	M
 Timothy 	M
 Tina 	F
 Tinnie 	F
 Tintagel 	M
 Tionna 	F
 Tiponi 	F
 Tipper 	M
 Tira 	F
 Tirell 	M
 Tisa 	F
 Tisha 	F
 Tito 	M
 Titus 	M
 Tiva 	F
 Tivona 	F
 Tiwesdaeg 	F
 Toba 	F
 Tobe 	M
 Tobey 	M
 Tobiah 	M
 Tobias 	M
 Tobie 	M
 Tobin 	M
 Tobrecan 	M
 Tobrytan 	M
 Toby 	M
 Tobyn 	M
 Tocho 	M
 Tod 	M
 Todd 	M
 Toft 	M
 Togquos 	M
 Tohias 	M
 Tohopka 	M
 Tohy 	M
 Toibe 	F
 Toireasa 	F
 Toivo 	M
 Tokala 	M
 Tolan 	M
 Toland 	M
 Toli 	M
 Tolland 	M
 Tolman 	M
 Tolucan 	M
 Tom 	M
 Tomas 	M
 Tomasa 	F
 Tomasina 	F
 Tomasine 	F
 Tomek 	M
 Tomeka 	F
 Tomi 	M
 Tomie 	M
 Tomika 	F
 Tomkin 	M
 Tomlin 	M
 Tommaso 	M
 Tommie 	M
 Tommy 	M
 Toney 	M
 Toni 	F
 Tonia 	F
 Tonio 	M
 Tonisha 	F
 Tonja 	F
 Tony 	M
 Tonya 	F
 Tooantuh 	M
 Tor 	M
 Toran 	M
 Torean 	M
 Toren 	M
 Torence 	M
 Torey 	M
 Torht 	M
 Torhte 	M
 Tori 	F
 Toriana 	F
 Torin 	M
 Torion 	M
 Torley 	M
 Tormaigh 	M
 Tormey 	M
 Toro 	M
 Torr 	M
 Torra 	F
 Torran 	M
 Torrance 	M
 Torrans 	M
 Torree 	F
 Torrence 	M
 Torrey 	M
 Torri 	F
 Torrian 	M
 Torrie 	M
 Torry 	M
 Tory 	M
 Toryn 	M
 Tosha 	F
 Tostig 	M
 Totsi 	F
 Toukere 	M
 Tournour 	M
 Toussnint 	M
 Tova 	F
 Tovi 	M
 Towley 	M
 Townly 	M
 Townsend 	M
 Toya 	F
 Trace 	M
 Tracee 	F
 Tracey 	F
 Traci 	F
 Tracie 	F
 Tracy 	F
 Trae 	M
 Trahern 	M
 Traigh 	M
 Tramaine 	M
 Traveon 	M
 Travers 	M
 Traviata 	F
 Travion 	M
 Travis 	M
 Travon 	M
 Tre 	M
 Treabhar 	M
 Treacy 	M
 Treadway 	M
 Treasa 	F
 Treasach 	M
 Treasigh 	M
 Tredan 	M
 Treddian 	M
 Tredway 	M
 Treffen 	M
 Treise 	F
 Trella 	F
 Tremain 	M
 Tremaine 	M
 Tremayne 	M
 Trena 	F
 Trennen 	M
 Trent 	M
 Trenten 	M
 Trentin 	M
 Trenton 	M
 Treowbrycg 	M
 Treowe 	M
 Treoweman 	M
 Tresa 	F
 Tressa 	F
 Tressie 	F
 Tretan 	M
 Treva 	F
 Trevan 	M
 Treven 	M
 Trever 	M
 Treves 	M
 Trevian 	M
 Trevion 	M
 Trevls 	M
 Trevon 	M
 Trevonn 	M
 Trevor 	M
 Trevrizent 	M
 Trevyn 	M
 Trey 	M
 Treyton 	M
 Tricia 	F
 Trilby 	F
 Trillare 	F
 Trina 	F
 Trinetta 	F
 Trinette 	F
 Trinidad 	F
 Trinity 	F
 Tripp 	M
 Tripper 	M
 Trisa 	F
 Trish 	F
 Trisha 	F
 Trista 	F
 Tristan 	M
 Tristen 	M
 Tristian 	M
 Tristin 	M
 Tristina 	F
 Triston 	M
 Tristram 	M
 Trixie 	F
 Troi 	M
 Trowbrydge 	M
 Trowhridge 	M
 Troy 	M
 Troye 	M
 Troyes 	M
 Truda 	F
 Trudchen 	F
 Trude 	F
 Trudel 	F
 Trudie 	F
 Trudy 	F
 Truesdale 	M
 Truesdell 	M
 Truitestall 	M
 Truman 	M
 Trumbald 	M
 Trumble 	M
 Trumen 	M
 Trumhall 	M
 Tryamon 	F
 Trymian 	M
 Trymman 	M
 Tryp 	M
 Trypp 	M
 Trystan 	M
 Tse 	M
 Tsidhqiyah 	M
 Tsifira 	F
 Tsiishch'ili 	M
 Tucker 	M
 Tuckere 	M
 Tugenda 	F
 Tuketu 	M
 Tulio 	M
 Tullia 	F
 Tully 	M
 Tunleah 	M
 Tuomas 	M
 Tupi 	M
 Tupper 	M
 Tuppere 	M
 Turi 	M
 Turner 	M
 Tutu 	M
 Tutyahu 	M
 Tuvya 	M
 Tuwa 	F
 Twain 	M
 Twein 	M
 Twiford 	M
 Twila 	F
 Twitchel 	M
 Twitchell 	M
 Twyford 	M
 Twyla 	F
 Tyce 	M
 Tye 	M
 Tyeis 	M
 Tyesha 	F
 Tyeson 	M
 Tyesone 	M
 Tyfiell 	M
 Tyg 	M
 Tyla 	M
 Tyler 	M
 Tylere 	M
 Tylor 	M
 Tyna 	F
 Tynan 	M
 Tyne 	F
 Tyquan 	M
 Tyra 	F
 Tyree 	M
 Tyreece 	M
 Tyrel 	M
 Tyrell 	M
 Tyrelle 	M
 Tyrese 	M
 Tyron 	M
 Tyrone 	M
 Tyronne 	M
 Tyrus 	M
 Tyshawn 	M
 Tyson 	M
 Tzadok 	M
 Tzefanyah 	M
 Tzefanyahu 	M
 Tzilla 	F
 Tzion 	M
 Tzippa 	F
 Tzivia 	F
 Tziyon 	M
 Tziyona 	F
 Tzuriel 	M
 Tzvi 	M
 Tzzipporah 	F
 Uaid 	M
 Ualtar 	M
 Ubel 	M
 Uchechi 	M
 Uchenna 	F
 Udale 	M
 Udall 	M
 Udayle 	M
 Udela 	F
 Udele 	F
 Udell 	M
 Udolf 	M
 Udolph 	M
 Ugo 	M
 Ula 	F
 Uldwyna 	F
 Ulfred 	M
 Ulger 	M
 Uli 	M
 Ulicia 	F
 Ulises 	M
 Ulka 	F
 Ulla 	F
 Ullock 	M
 Ullok 	M
 Ulmar 	M
 Ulmarr 	M
 Ulrica 	F
 Ulrich 	M
 Ulrik 	M
 Ulrike 	F
 Ulu 	F
 Ulvelaik 	M
 Ulysses 	M
 Ulz 	M
 Una 	F
 Ungus 	M
 Unwin 	M
 Unwine 	M
 Unwyn 	M
 Uny 	F
 Upchurch 	M
 Upton 	M
 Uptun 	M
 Upwode 	M
 Upwood 	M
 Urbano 	M
 Urenna 	F
 Uri 	M
 Uriah 	M
 Urice 	F
 Uriel 	M
 Urien 	M
 Uriens 	M
 Urit 	F
 Urquhart 	M
 Ursula 	F
 Ursulina 	F
 Usbeorn 	M
 Usoa 	F
 Uther 	M
 Uzumati 	M
 Uzziah 	M
 Uzziel 	M
 Uzziye 	F
 Vachel 	M
 Vada 	F
 Vadit 	F
 Vafara 	F
 Vail 	M
 Val 	M
 Valarie 	F
 Valborga 	F
 Valdemar 	M
 Valdemarr 	M
 Valen 	M
 Valencia 	F
 Valentin 	M
 Valentina 	F
 Valentine 	M
 Valentino 	M
 Valeraine 	F
 Valere 	F
 Valeria 	F
 Valerie 	F
 Vallen 	M
 Vallie 	F
 Vallis 	M
 Vallois 	M
 Valorie 	F
 Van_Aken 	M
 Van_Eych 	M
 Van_Ness 	M
 Vance 	M
 Vanda 	F
 Vande 	F
 Vanderbilt 	M
 Vanderpool 	M
 Vanderveer 	M
 Vandyke 	M
 Vanesa 	F
 Vanessa 	F
 Vania 	F
 Vanna 	F
 Vannes 	M
 Vannie 	F
 Varda 	F
 Vardan 	M
 Varden 	M
 Vardit 	F
 Vardon 	M
 Vareck 	M
 Vared 	F
 Varek 	M
 Varik 	M
 Varney 	M
 Vassie 	F
 Vaughn 	M
 Vayle 	M
 Veda 	F
 Vedetta 	F
 Vedette 	F
 Vega 	F
 Velda 	F
 Vella 	F
 Velma 	F
 Velouette 	F
 Velva 	F
 Velvet 	F
 Vemados 	M
 Vena 	F
 Venamin 	M
 Venessa 	F
 Venetia 	F
 Veniamin 	M
 Venita 	F
 Venjamin 	M
 Vennie 	F
 Ventura 	F
 Venus 	F
 Vera 	F
 Verbrugge 	M
 Verda 	F
 Verdad 	F
 Verddun 	M
 Verdell 	M
 Verdie 	F
 Verel 	M
 Verena 	F
 Verene 	F
 Vergie 	F
 Vergil 	M
 Verina 	F
 Verl 	M
 Verla 	F
 Verle 	M
 Verlene 	F
 Verlie 	F
 Verlin 	M
 Verlyn 	M
 Vern 	M
 Verna 	F
 Vernay 	M
 Verne 	M
 Vernell 	F
 Verner 	M
 Verney 	M
 Vernice 	F
 Vernie 	F
 Vernon 	M
 Verona 	F
 Veronica 	F
 Veronique 	F
 Verrall 	M
 Verrell 	M
 Verrill 	M
 Versie 	F
 Vertie 	F
 Veryl 	M
 Vesta 	F
 Vester 	M
 Veta 	F
 Veva 	F
 Vevila 	F
 Vevina 	F
 Vibeke 	F
 Vic 	M
 Vicenta 	F
 Vicente 	M
 Vick 	M
 Vickey 	F
 Vicki 	F
 Vickie 	F
 Vicky 	F
 Vicq 	M
 Victoria 	F
 Victoriano 	M
 Victorina 	F
 Victorine 	F
 Victorino 	M
 Victorio 	M
 Victoro 	M
 Vida 	F
 Vidal 	M
 Videl 	M
 Vidette 	F
 Vignetta 	F
 Viheke 	F
 Viho 	M
 Vika 	F
 Vikki 	F
 Vilhelm 	M
 Villetta 	F
 Villette 	F
 Vilma 	F
 Vina 	F
 Vince 	M
 Vincent 	M
 Vincente 	M
 Vincenza 	F
 Vincenzio 	M
 Vincenzo 	M
 Vingon 	M
 Vinn 	M
 Vinnie 	F
 Vinson 	M
 Vinsone 	M
 Violetta 	F
 Violette 	F
 Viollette 	F
 Vipponah 	M
 Vira 	F
 Viradecthis 	F
 Virgena 	F
 Virgie 	F
 Virgil 	M
 Virgilio 	M
 Virginia 	F
 Virgle 	M
 Vita 	F
 Vito 	M
 Vittoria 	F
 Vittorio 	M
 Viva 	F
 Viveka 	F
 Vivian 	F
 Viviana 	F
 Viviane 	F
 Vivianna 	F
 Vivianne 	F
 Vivien 	F
 Vivienne 	F
 Vlasta 	F
 Vogel 	M
 Vohkinne 	M
 Voistitoevitz 	M
 Voisttitoevetz 	M
 Vokivocummast 	M
 Volante 	F
 Voleta 	F
 Voletta 	F
 VolIny 	M
 Volker 	M
 Volney 	M
 Von 	M
 Vonda 	F
 Vonnie 	F
 Vortigem 	M
 Vortimer 	M
 Vromme 	M
 Vruyk 	M
 Wacfeld 	M
 Wacian 	M
 Wacleah 	M
 Wacuman 	M
 Wada 	M
 Wadanhyll 	M
 Wade 	M
 Wadley 	M
 Wadsworth 	M
 Waed 	M
 Waefreleah 	M
 Waer 	M
 Waerheall 	M
 Waeringawicum 	M
 Waescburne 	M
 Wafiyy 	M
 Wagner 	M
 Wahanassatta 	M
 Wahchinksapa 	M
 Wahchintonka 	M
 Wahkan 	M
 Wain 	M
 Wainwright 	M
 Waite 	M
 Wakefield 	M
 Wakeley 	M
 Wakeman 	M
 Waki 	F
 Wakiza 	M
 Wakler 	M
 Walborgd 	F
 Walbridge 	M
 Walbrydge 	M
 Walby 	M
 Walcot 	M
 Walcott 	M
 Walda 	F
 Waldemar 	M
 Waldemarr 	M
 Walden 	M
 Waldhramm 	M
 Waldhurga 	F
 Waldifrid 	M
 Waldmunt 	M
 Waldo 	M
 Waldon 	M
 Waldrom 	M
 Waldron 	M
 Waleis 	M
 Walford 	M
 Walfred 	M
 Walfrid 	M
 Walker 	M
 Wallace 	M
 Wallache 	M
 Waller 	M
 Wallis 	M
 Wally 	M
 Walmond 	M
 Walsh 	M
 Walt 	M
 Walten 	M
 Walter 	M
 Walthari 	M
 Walton 	M
 Walworth 	M
 Walwyn 	M
 Wamblee 	M
 Wambleesha 	M
 Wambli waste 	M
 Wan 	F
 Wanageeska 	M
 Wanahton 	M
 Wanda 	F
 Wande 	F
 Wandy 	F
 Waneta 	F
 Wanetta 	F
 Wanikiy 	M
 Wann 	M
 Wanrrick 	M
 Wanyika 	F
 Wapi 	M
 Waqi 	F
 Waquini 	M
 Ward 	M
 Warda 	F
 Warde 	M
 Wardell 	M
 Warden 	M
 Wardley 	M
 Wareine 	M
 Waren 	M
 Warenhari 	M
 Warfield 	M
 Warford 	M
 Warian 	M
 Warleigh 	M
 Warley 	M
 Warner 	M
 Warrane 	M
 Warren 	M
 Warrick 	M
 Warton 	M
 Wartun 	M
 Warwyk 	M
 Washbourne 	M
 Washburn 	M
 Washburne 	M
 Washington 	M
 Wasim 	M
 Wat 	M
 Watelford 	M
 Watford 	M
 Watkins 	M
 Watson 	M
 Watt 	M
 Wattekinson 	M
 Wattesone 	M
 Wattikinson 	M
 Wattkins 	M
 Watts 	M
 Wattson 	M
 Waverly 	M
 Wayde 	M
 Waydell 	M
 Waylan 	M
 Wayland 	M
 Waylin 	M
 Waylon 	M
 Wayman 	M
 Waymon 	M
 Wayne 	M
 Wayte 	M
 Wealaworth 	M
 Weallcot 	M
 Weallere 	M
 Weard 	M
 Weardhyll 	M
 Weardleah 	M
 Weatherby 	M
 Weatherly 	M
 Weayaya 	M
 Webb 	M
 Webbe 	M
 Webbeleah 	M
 Webber 	M
 Webbestre 	M
 Weber 	M
 Webley 	M
 Webster 	M
 Weddell 	M
 Wegland 	M
 Wei 	F
 Weifield 	M
 Weiford 	M
 Weirley 	M
 Welborn 	M
 Welborne 	M
 Welburn 	M
 Welby 	M
 Welch 	M
 Welda 	F
 Weldon 	M
 Welford 	M
 Welles 	M
 Wellington 	M
 Wells 	M
 Welsh 	M
 Welsie 	F
 Welss 	F
 Welton 	M
 Wenda 	F
 Wendale 	M
 Wendall 	M
 Wendel 	M
 Wendell 	M
 Wendi 	F
 Wendy 	F
 Wenona 	F
 Wentworth 	M
 Werner 	M
 Wes 	M
 Weslee 	F
 Wesley 	M
 Weslia 	F
 Wessley 	M
 Westbrook 	M
 Westby 	M
 Westcot 	M
 Westcott 	M
 Westen 	M
 Westin 	M
 Westley 	M
 Weston 	M
 Wetherby 	M
 Wetherly 	M
 Wethrby 	M
 Wevers 	M
 Weyland 	M
 Weylin 	M
 Weylyn 	M
 Wharton 	M
 Wheatley 	M
 Wheeler 	M
 Whelan 	M
 Whistler 	M
 Whitby 	M
 Whitcomb 	M
 Whitelaw 	M
 Whitfield 	M
 Whitford 	M
 Whitlaw 	M
 Whitley 	M
 Whitlock 	M
 Whitman 	M
 Whitmoor 	M
 Whitmore 	M
 Whitney 	F
 Whittaker 	M
 Wiatt 	M
 Wiccum 	M
 Wichamm 	M
 Wichell 	M
 Wickam 	M
 Wigman 	M
 Wilbart 	M
 Wilber 	M
 Wilbert 	M
 Wilbur 	M
 Wilburn 	M
 Wilburt 	M
 Wilda 	F
 Wilde 	F
 Wiley 	M
 Wilford 	M
 Wilfred 	M
 Wilfredo 	M
 Wilfrid 	M
 Wilfryd 	M
 Wilhelm 	M
 Wilhelmina 	F
 Wilhelmine 	F
 Willa 	F
 Willaburh 	M
 Willam 	M
 Willamar 	M
 Willaperht 	M
 Willard 	M
 Willene 	F
 Willesone 	M
 Willhard 	M
 Willia 	F
 William 	M
 Willian 	M
 Willie 	M
 Willifrid 	M
 Willis 	M
 Willmar 	M
 Willmarr 	M
 Willoughby 	M
 Willow 	F
 Willy 	M
 Wilma 	F
 Wilmar 	M
 Wilmer 	M
 Wilmod 	M
 Wilmot 	M
 Wilona 	F
 Wilpert 	M
 Wilson 	M
 Wilton 	M
 Wincel 	M
 Winchell 	M
 Windell 	M
 Windgate 	M
 Windham 	M
 Windsor 	M
 Winefield 	M
 Winefrith 	M
 Winema 	F
 Winfield 	M
 Winford 	M
 Winfred 	M
 Winfrid 	M
 Winfrith 	M
 Wingate 	M
 Winifred 	F
 Winifreda 	F
 Winifrid 	F
 Winifride 	F
 Winn 	M
 Winnie 	F
 Winnifred 	F
 Winola 	F
 Winona 	F
 Winslow 	M
 Winslowe 	M
 Winsor 	M
 Winston 	M
 Winthorp 	M
 Winthrop 	M
 Winton 	M
 Witt 	M
 Woden 	M
 Wolcott 	M
 Wolfcot 	M
 Wolfe 	M
 Wolfgang 	M
 Wolfric 	M
 Wolfrick 	M
 Wolfrik 	M
 Woodie 	M
 Woodley 	M
 Woodman 	M
 Woodroe 	M
 Woodrow 	M
 Woodruff 	M
 Woodward 	M
 Woody 	M
 Woolcott 	M
 Woolsey 	M
 Worcester 	M
 Worden 	M
 Wordsworth 	M
 Worrell 	M
 Worthington 	M
 Worton 	M
 Wulfgar 	M
 Wyatt 	M
 WycIyf 	M
 Wycliff 	M
 Wylie 	M
 Wyman 	M
 Wymer 	M
 Wynchell 	M
 Wynda 	F
 Wyndell 	M
 Wyndham 	M
 Wyne 	M
 Wynfield 	M
 Wynfrith 	M
 Wynn 	M
 Wynne 	M
 Wynnie 	F
 Wynona 	F
 Wynono 	M
 Wynston 	M
 Wynter 	M
 Wynthrop 	M
 Wynton 	M
 Wyth 	M
 Wythe 	M
 Xander 	M
 Xandra 	F
 Xarles 	M
 Xavier 	M
 Xaviera 	F
 Xavierra 	F
 Xavierre 	F
 Xevera 	F
 Xeveria 	F
 Yancy 	M
 Yanis 	M
 Yardley 	M
 Yardly 	M
 Yasir 	M
 Yasmeen 	F
 Yasmia 	F
 Yasmin 	F
 Yasmina 	F
 Yasmine 	F
 Yates 	M
 Yazmin 	F
 Yolanda 	F
 Yolonda 	F
 Yosef 	M
 Yoshiko 	F
 Yoshio 	M
 Yusuf 	M
 Yvette 	F
 Yvonne 	F
 Zachariah 	M
 Zachary 	M
 Zachery 	M
 Zack 	M
 Zackary 	M
 Zackery 	M
 Zada 	F
 Zadie 	F
 Zain 	M
 Zaire 	M
 Zakary 	M
 Zander 	M
 Zane 	M
 Zaria 	F
 Zavier 	M
 Zeb 	M
 Zechariah 	M
 Zelda 	F
 Zelia 	F
 Zella 	F
 Zelma 	F
 Zena 	F
 Zetta 	F
 Zettie 	F
 Zigmund 	M
 Zina 	F
 Zion 	M
 Zita 	F
 Zoa 	F
 Zoe 	F
 Zoey 	F
 Zoie 	F
 Zola 	F
 Zollie 	M
 Zona 	F
 Zora 	F
 Latifa 	F
 Zeque 	M
 Alladin 	M
 Tenille 	F
 Igor 	M
 Alexey 	M
 Zak 	M
